id,bod,datum,votes_pro,votes_proti,votes_zdrzel,votes_nehlasoval,prihlaseno,vysledek,nazev
52361,3,1277157600,192,0,3,0,195,A,Inf.%20o%20ustaven%ED%20volebn%ED%20komise%20PS%20a%20volb%u011B%20%u010Dlen%u016F
52362,4,1277157600,191,0,4,1,196,A,N%E1v.na%20stanoven%ED%20po%u010Dtu%20%u010Dl.%20MIV
52363,6,1277330400,192,0,5,0,197,A,N%E1vrh%20na%20ustaven%ED%20MIV
52364,8,1277330400,159,0,26,0,185,A,Inf.%20MIV%20o%20ov%u011B%u0159en%ED%20platnosti%20volby%20poslanc%u016F
52365,10,1277330400,118,21,53,8,200,A,N%E1vrh%20na%20stanoven%ED%20po%u010Dtu%20m%EDstop%u0159edsed%u016F%20PS
52366,10,1277330400,54,16,119,10,199,R,N%E1vrh%20na%20stanoven%ED%20po%u010Dtu%20m%EDstop%u0159edsed%u016F%20PS
52367,10,1277330400,46,14,126,13,199,R,N%E1vrh%20na%20stanoven%ED%20po%u010Dtu%20m%EDstop%u0159edsed%u016F%20PS
52368,10,1277330400,120,45,13,22,200,A,N%E1vrh%20na%20stanoven%ED%20po%u010Dtu%20m%EDstop%u0159edsed%u016F%20PS
52369,12,1277330400,184,0,13,0,197,A,N%E1vrh%20na%20stanoven%ED%20po%u010Dtu%20ov%u011B%u0159ovatel%u016F%20PS
52370,13,1277330400,190,0,8,0,198,A,N%E1vrh%20na%20nominaci%20ov%u011B%u0159ovatel%u016F%20PS
52371,0,1277330400,190,0,9,0,199,A,%20
52372,14,1277330400,168,1,18,11,198,A,N%E1vrh%20na%20z%u0159%EDzen%ED%20v%FDbor%u016F%20PS
52373,15,1277330400,147,11,33,7,198,A,N%E1vrh%20na%20stanoven%ED%20po%u010Dtu%20%u010Dlen%u016F%20v%FDbor%u016F%20PS
52374,15,1277330400,40,20,124,13,197,R,N%E1vrh%20na%20stanoven%ED%20po%u010Dtu%20%u010Dlen%u016F%20v%FDbor%u016F%20PS
52375,15,1277330400,164,7,24,3,198,A,N%E1vrh%20na%20stanoven%ED%20po%u010Dtu%20%u010Dlen%u016F%20v%FDbor%u016F%20PS
52376,15,1277330400,183,1,13,1,198,A,N%E1vrh%20na%20stanoven%ED%20po%u010Dtu%20%u010Dlen%u016F%20v%FDbor%u016F%20PS
52377,17,1277330400,186,1,8,2,197,A,N%E1vrh%20term%EDnu%202.%20sch%u016Fze%20PS
52378,0,1278453600,159,0,10,0,169,A,%20
52379,0,1278453600,179,0,3,0,182,A,Po%u0159ad%20sch%u016Fze
52380,0,1278453600,183,0,3,0,186,A,Po%u0159ad%20sch%u016Fze
52381,1,1278453600,182,1,2,1,186,A,N%E1v.%20zasedac%EDho%20po%u0159%E1dku%20poslanc%u016F%20v%20jedn.%20s%E1le%20PS
52382,2,1278453600,181,0,9,0,190,A,N%E1v.%20na%20ustaven%ED%20v%FDbor%u016F%20PS
52383,2,1278453600,184,0,6,0,190,A,N%E1v.%20na%20ustaven%ED%20v%FDbor%u016F%20PS
52384,2,1278453600,186,1,5,0,192,A,N%E1v.%20na%20ustaven%ED%20v%FDbor%u016F%20PS
52385,2,1278453600,186,1,5,1,193,A,N%E1v.%20na%20ustaven%ED%20v%FDbor%u016F%20PS
52386,2,1278453600,187,1,4,1,193,A,N%E1v.%20na%20ustaven%ED%20v%FDbor%u016F%20PS
52387,2,1278453600,188,2,2,1,193,A,N%E1v.%20na%20ustaven%ED%20v%FDbor%u016F%20PS
52388,2,1278453600,191,1,1,0,193,A,N%E1v.%20na%20ustaven%ED%20v%FDbor%u016F%20PS
52389,2,1278453600,189,2,2,0,193,A,N%E1v.%20na%20ustaven%ED%20v%FDbor%u016F%20PS
52390,2,1278453600,188,1,1,3,193,A,N%E1v.%20na%20ustaven%ED%20v%FDbor%u016F%20PS
52391,2,1278453600,192,0,1,0,193,A,N%E1v.%20na%20ustaven%ED%20v%FDbor%u016F%20PS
52392,2,1278453600,191,0,2,0,193,A,N%E1v.%20na%20ustaven%ED%20v%FDbor%u016F%20PS
52393,2,1278453600,192,0,1,0,193,A,N%E1v.%20na%20ustaven%ED%20v%FDbor%u016F%20PS
52394,2,1278453600,191,0,2,0,193,A,N%E1v.%20na%20ustaven%ED%20v%FDbor%u016F%20PS
52395,2,1278453600,192,0,1,0,193,A,N%E1v.%20na%20ustaven%ED%20v%FDbor%u016F%20PS
52396,2,1278453600,192,0,1,0,193,A,N%E1v.%20na%20ustaven%ED%20v%FDbor%u016F%20PS
52397,2,1278453600,190,0,2,1,193,A,N%E1v.%20na%20ustaven%ED%20v%FDbor%u016F%20PS
52398,3,1278453600,181,2,6,5,194,A,N.na%20potvrz.platnosti%20usn.o%20%FAprav%u011B%20vnit%u0159.pom%u011Br%u016F
52399,3,1278453600,115,70,2,5,192,A,N.na%20potvrz.platnosti%20usn.o%20%FAprav%u011B%20vnit%u0159.pom%u011Br%u016F
52400,3,1278453600,185,1,3,4,193,A,N.na%20potvrz.platnosti%20usn.o%20%FAprav%u011B%20vnit%u0159.pom%u011Br%u016F
52401,3,1278453600,176,0,9,8,193,A,N.na%20potvrz.platnosti%20usn.o%20%FAprav%u011B%20vnit%u0159.pom%u011Br%u016F
52402,3,1278453600,158,7,13,15,193,A,N.na%20potvrz.platnosti%20usn.o%20%FAprav%u011B%20vnit%u0159.pom%u011Br%u016F
52403,3,1278453600,160,7,13,13,193,A,N.na%20potvrz.platnosti%20usn.o%20%FAprav%u011B%20vnit%u0159.pom%u011Br%u016F
52404,4,1278453600,181,0,11,1,193,A,N%E1vrh%20na%20z%u0159%EDzen%ED%20st%E1l%FDch%20komis%ED%20PS
52405,4,1278453600,174,0,16,3,193,A,N%E1vrh%20na%20z%u0159%EDzen%ED%20st%E1l%FDch%20komis%ED%20PS
52406,4,1278453600,177,0,14,1,192,A,N%E1vrh%20na%20z%u0159%EDzen%ED%20st%E1l%FDch%20komis%ED%20PS
52407,4,1278453600,178,0,13,1,192,A,N%E1vrh%20na%20z%u0159%EDzen%ED%20st%E1l%FDch%20komis%ED%20PS
52408,8,1278453600,179,0,13,0,192,A,N%E1vrh%20na%20z%u0159%EDzen%ED%20st%E1l%E9%20komise%20pro%20kontrolu%20NB%DA
52409,9,1278453600,172,0,21,0,193,A,N%E1vrh%20na%20stanoven%ED%20po%u010Dtu%20poslanc%u016F%20ve%20st%E1l%FDch%20delegac%EDch
52410,12,1278453600,165,1,21,1,188,A,N%E1vrh%20na%20volbu%20Ve%u0159ejn%E9ho%20ochr%E1nce%20pr%E1v
52411,0,1278626400,146,2,15,3,166,A,2.%20sch%u016Fze%20bude%20pokra%u010Dovat%20v%209%3A00
52412,0,1278626400,150,3,9,4,166,A,2.%20sch%u016Fze%20bude%20pokra%u010Dovat%20v%209%3A00
52413,12,1278626400,171,0,3,1,175,A,N%E1vrh%20na%20volbu%20Ve%u0159ejn%E9ho%20ochr%E1nce%20pr%E1v
52414,12,1278626400,167,2,8,3,180,A,N%E1vrh%20na%20volbu%20Ve%u0159ejn%E9ho%20ochr%E1nce%20pr%E1v
52415,12,1278626400,149,1,38,0,188,A,N%E1vrh%20na%20volbu%20Ve%u0159ejn%E9ho%20ochr%E1nce%20pr%E1v
52416,13,1278626400,167,0,16,1,184,A,N%E1v.%20na%20potvrzen%ED%20p%u0159edsed%u016F%20v%FDbor%u016F%20PS
52417,13,1278626400,169,0,15,1,185,A,N%E1v.%20na%20potvrzen%ED%20p%u0159edsed%u016F%20v%FDbor%u016F%20PS
52418,13,1278626400,175,0,7,2,184,A,N%E1v.%20na%20potvrzen%ED%20p%u0159edsed%u016F%20v%FDbor%u016F%20PS
52419,13,1278626400,173,0,9,3,185,A,N%E1v.%20na%20potvrzen%ED%20p%u0159edsed%u016F%20v%FDbor%u016F%20PS
52420,13,1278626400,176,0,9,1,186,A,N%E1v.%20na%20potvrzen%ED%20p%u0159edsed%u016F%20v%FDbor%u016F%20PS
52421,13,1278626400,166,0,17,3,186,A,N%E1v.%20na%20potvrzen%ED%20p%u0159edsed%u016F%20v%FDbor%u016F%20PS
52422,13,1278626400,179,1,5,1,186,A,N%E1v.%20na%20potvrzen%ED%20p%u0159edsed%u016F%20v%FDbor%u016F%20PS
52423,13,1278626400,169,1,12,4,186,A,N%E1v.%20na%20potvrzen%ED%20p%u0159edsed%u016F%20v%FDbor%u016F%20PS
52424,13,1278626400,172,0,10,4,186,A,N%E1v.%20na%20potvrzen%ED%20p%u0159edsed%u016F%20v%FDbor%u016F%20PS
52425,13,1278626400,168,3,8,6,185,A,N%E1v.%20na%20potvrzen%ED%20p%u0159edsed%u016F%20v%FDbor%u016F%20PS
52426,13,1278626400,176,1,7,2,186,A,N%E1v.%20na%20potvrzen%ED%20p%u0159edsed%u016F%20v%FDbor%u016F%20PS
52427,13,1278626400,169,1,12,4,186,A,N%E1v.%20na%20potvrzen%ED%20p%u0159edsed%u016F%20v%FDbor%u016F%20PS
52428,13,1278626400,162,6,10,7,185,A,N%E1v.%20na%20potvrzen%ED%20p%u0159edsed%u016F%20v%FDbor%u016F%20PS
52429,13,1278626400,175,2,7,2,186,A,N%E1v.%20na%20potvrzen%ED%20p%u0159edsed%u016F%20v%FDbor%u016F%20PS
52430,13,1278626400,181,0,5,0,186,A,N%E1v.%20na%20potvrzen%ED%20p%u0159edsed%u016F%20v%FDbor%u016F%20PS
52431,14,1278626400,176,0,9,0,185,A,N%E1vrh%20na%20ustaven%ED%20nebo%20volbu%20%u010Dlen%u016F%20st%E1l%FDch%20komis%ED%20PS
52432,14,1278626400,176,0,9,0,185,A,N%E1vrh%20na%20ustaven%ED%20nebo%20volbu%20%u010Dlen%u016F%20st%E1l%FDch%20komis%ED%20PS
52433,15,1278626400,173,1,12,0,186,A,N%E1vrh%20na%20volbu%20%u010Dlen%u016F%20nebo%20ustaven%ED%20SK%20BIS
52434,16,1278626400,172,1,11,1,185,A,N%E1vrh%20na%20volbu%20%u010Dlen%u016F%20nebo%20ustaven%ED%20SK%20KPOTP
52435,17,1278626400,173,0,12,0,185,A,N%E1vrh%20na%20volbu%20%u010Dlen%u016F%20nebo%20ustaven%ED%20SK%20VZ
52436,18,1278626400,175,0,10,0,185,A,N%E1vrh%20na%20volbu%20%u010Dlen%u016F%20nebo%20ustaven%ED%20SK%20NB%DA
52437,19,1278626400,171,0,13,0,184,A,N%E1vrh%20na%20volbu%20%u010Dlen%u016F%20do%20st%E1l%FDch%20delegac%ED%20Parlamentu
52438,19,1278626400,172,0,12,0,184,A,N%E1vrh%20na%20volbu%20%u010Dlen%u016F%20do%20st%E1l%FDch%20delegac%ED%20Parlamentu
52439,21,1278626400,167,0,18,0,185,A,N%E1vrh%20na%20%FAhradu%20volebn%EDch%20n%E1klad%u016F%20za%20volby%20do%20PS%20v%20roce%202010
52440,0,1281391200,178,2,10,0,190,A,%20
52441,0,1281391200,182,4,6,3,195,A,Po%u0159ad%20sch%u016Fze
52442,0,1281391200,189,1,5,1,196,A,Po%u0159ad%20sch%u016Fze
52443,1,1281391200,135,2,18,6,161,A,%u017D%E1dost%20vl%E1dy%20%u010Cesk%E9%20republiky%20o%20vysloven%ED%20d%u016Fv%u011Bry
52444,1,1281391200,118,82,0,0,200,A,%u017D%E1dost%20vl%E1dy%20%u010Cesk%E9%20republiky%20o%20vysloven%ED%20d%u016Fv%u011Bry
52445,2,1281391200,146,5,17,26,194,A,N%E1vrh%20%u010Dasov%E9ho%20harmonogramu%20projedn%E1v%E1n%ED%20SZ%DA%202009
52446,0,1283810400,144,0,28,1,173,A,%20
52447,0,1283810400,160,3,15,3,181,A,Po%u0159ad%20sch%u016Fze
52448,0,1283810400,167,1,16,0,184,A,%20
52449,1,1283810400,159,1,23,2,185,A,N%E1vrh%20na%20volbu%20Ve%u0159ejn%E9ho%20ochr%E1nce%20pr%E1v
52450,1,1283810400,159,1,28,0,188,A,N%E1vrh%20na%20volbu%20Ve%u0159ejn%E9ho%20ochr%E1nce%20pr%E1v
52451,2,1283810400,161,0,10,1,172,A,Novela%20z.%20o%20ve%u0159ejn%FDch%20zak%E1zk%E1ch
52452,2,1283810400,171,0,3,1,175,A,Novela%20z.%20o%20ve%u0159ejn%FDch%20zak%E1zk%E1ch
52453,2,1283810400,73,71,14,18,176,R,Novela%20z.%20o%20ve%u0159ejn%FDch%20zak%E1zk%E1ch
52454,2,1283810400,145,9,13,10,177,A,Novela%20z.%20o%20ve%u0159ejn%FDch%20zak%E1zk%E1ch
52455,0,1285020000,100,0,24,0,124,A,%20
52456,0,1285020000,101,10,41,26,178,A,Po%u0159ad%20sch%u016Fze
52457,0,1285020000,123,6,38,16,183,A,Po%u0159ad%20sch%u016Fze
52458,0,1285020000,105,20,36,24,185,A,Po%u0159ad%20sch%u016Fze
52459,0,1285020000,176,0,9,0,185,A,Po%u0159ad%20sch%u016Fze
52460,0,1285020000,146,3,28,8,185,A,Po%u0159ad%20sch%u016Fze
52461,0,1285020000,162,4,10,9,185,A,Po%u0159ad%20sch%u016Fze
52462,0,1285020000,74,102,6,3,185,R,Po%u0159ad%20sch%u016Fze
52463,0,1285020000,79,96,6,3,184,R,Po%u0159ad%20sch%u016Fze
52464,0,1285020000,73,94,5,11,183,R,Po%u0159ad%20sch%u016Fze
52465,0,1285020000,115,27,26,15,183,A,Po%u0159ad%20sch%u016Fze
52466,0,1285020000,76,75,19,13,183,R,Po%u0159ad%20sch%u016Fze
52467,0,1285020000,79,101,1,3,184,R,Po%u0159ad%20sch%u016Fze
52468,0,1285020000,143,8,15,18,184,A,Po%u0159ad%20sch%u016Fze
52469,0,1285020000,111,22,28,23,184,A,Po%u0159ad%20sch%u016Fze
52470,0,1285020000,108,40,28,8,184,A,Po%u0159ad%20sch%u016Fze
52471,0,1285020000,107,70,5,2,184,A,Po%u0159ad%20sch%u016Fze
52472,1,1285020000,137,0,44,0,181,A,Novela%20z.%20o%20krizov%E9m%20%u0159%EDzen%ED%20-%20EU
52473,1,1285020000,60,63,42,15,180,R,Novela%20z.%20o%20krizov%E9m%20%u0159%EDzen%ED%20-%20EU
52474,1,1285020000,117,6,49,8,180,A,Novela%20z.%20o%20krizov%E9m%20%u0159%EDzen%ED%20-%20EU
52475,2,1285020000,149,0,0,0,149,A,Novela%20z.%20o%20pobytu%20cizinc%u016F%20na%20%FAzem%ED%20%u010CR
52476,2,1285020000,61,56,16,19,152,R,Novela%20z.%20o%20pobytu%20cizinc%u016F%20na%20%FAzem%ED%20%u010CR
52477,2,1285020000,55,70,13,14,152,R,Novela%20z.%20o%20pobytu%20cizinc%u016F%20na%20%FAzem%ED%20%u010CR
52478,2,1285020000,95,23,25,11,154,A,Novela%20z.%20o%20pobytu%20cizinc%u016F%20na%20%FAzem%ED%20%u010CR
52479,3,1285020000,135,0,20,2,157,A,Novela%20z.%20o%20z%E1kladn%EDch%20registrech
52480,3,1285020000,95,19,39,5,158,A,Novela%20z.%20o%20z%E1kladn%EDch%20registrech
52481,4,1285020000,96,23,15,20,154,A,N%E1vrh%20na%20zkr%E1cen%ED%20lh%u016Fty%20pro%20projedn%E1n%ED%20sn%u011Bmovn%EDho%20tisku%2045
52482,5,1285020000,139,0,19,0,158,A,Novela%20z.%20%DAstava%20%u010Cesk%E9%20republiky
52483,5,1285020000,153,0,8,1,162,A,Novela%20z.%20%DAstava%20%u010Cesk%E9%20republiky
52484,5,1285020000,143,3,12,5,163,A,Novela%20z.%20%DAstava%20%u010Cesk%E9%20republiky
52485,6,1285020000,110,2,44,5,161,A,Novela%20z.%20-%20re%u017Eim%20Evrop.%20spole%u010D.%20pro%20kontrolu%20v%FDvozu%20zbo%u017E%ED%20-%20EU
52486,6,1285020000,120,0,39,3,162,A,Novela%20z.%20-%20re%u017Eim%20Evrop.%20spole%u010D.%20pro%20kontrolu%20v%FDvozu%20zbo%u017E%ED%20-%20EU
52487,0,1285106400,125,8,23,4,160,A,Po%u0159ad%20sch%u016Fze
52488,0,1285106400,161,1,7,0,169,A,Po%u0159ad%20sch%u016Fze
52489,10,1285106400,138,0,24,9,171,A,Vl.n.z.%20o%20finan%u010Dn%EDm%20zaji%u0161t%u011Bn%ED%20-%20EU
52490,11,1285106400,115,6,45,9,175,A,Vl.n.z.%20o%20zm%u011Bn%u011B%20z%E1kon%u016F%20v%20souvisl.%20s%20p%u0159ij.%20z%E1k.o%20fin.zaji%u0161t%u011Bn%ED%20-%20EU
52491,11,1285106400,135,1,36,3,175,A,Vl.n.z.%20o%20zm%u011Bn%u011B%20z%E1kon%u016F%20v%20souvisl.%20s%20p%u0159ij.%20z%E1k.o%20fin.zaji%u0161t%u011Bn%ED%20-%20EU
52492,11,1285106400,123,2,45,6,176,A,Vl.n.z.%20o%20zm%u011Bn%u011B%20z%E1kon%u016F%20v%20souvisl.%20s%20p%u0159ij.%20z%E1k.o%20fin.zaji%u0161t%u011Bn%ED%20-%20EU
52493,11,1285106400,147,2,26,1,176,A,Vl.n.z.%20o%20zm%u011Bn%u011B%20z%E1kon%u016F%20v%20souvisl.%20s%20p%u0159ij.%20z%E1k.o%20fin.zaji%u0161t%u011Bn%ED%20-%20EU
52494,11,1285106400,123,3,43,7,176,A,Vl.n.z.%20o%20zm%u011Bn%u011B%20z%E1kon%u016F%20v%20souvisl.%20s%20p%u0159ij.%20z%E1k.o%20fin.zaji%u0161t%u011Bn%ED%20-%20EU
52495,12,1285106400,140,1,33,0,174,A,Novela%20z.%20o%20%FA%u010Detnictv%ED%20-%20EU
52496,12,1285106400,121,5,44,4,174,A,Novela%20z.%20o%20%FA%u010Detnictv%ED%20-%20EU
52497,43,1285106400,133,1,38,3,175,A,%DAmluva%20o%20pou%u017E%EDv%E1n%ED%20informa%u010Dn%ED%20technologie%20pro%20celn%ED%20%FA%u010Dely
52498,43,1285106400,116,3,50,7,176,A,%DAmluva%20o%20pou%u017E%EDv%E1n%ED%20informa%u010Dn%ED%20technologie%20pro%20celn%ED%20%FA%u010Dely
52499,57,1285106400,139,2,34,2,177,A,%DAmluva%20o%20centralizovan%E9m%20celn%EDm%20%u0159%EDzen%ED
52500,40,1285106400,124,2,45,4,175,A,Prot.%20o%20p%u0159echodn%FDch%20ustanoven%EDch%20ke%20Smlouv%u011B%20o%20Evropsk%E9%20unii
52501,40,1285106400,106,1,62,6,175,A,Prot.%20o%20p%u0159echodn%FDch%20ustanoven%EDch%20ke%20Smlouv%u011B%20o%20Evropsk%E9%20unii
52502,53,1285106400,129,0,40,1,170,A,Doh.o%20stabilizaci%20a%20p%u0159idru%u017Een%ED%20mezi%20ES%20a%20Rep.Srbsko
52503,53,1285106400,105,1,57,8,171,A,Doh.o%20stabilizaci%20a%20p%u0159idru%u017Een%ED%20mezi%20ES%20a%20Rep.Srbsko
52504,90,1285106400,91,4,55,29,179,A,Novela%20z.%20o%20ve%u0159ejn%FDch%20zak%E1zk%E1ch
52505,7,1285106400,1,2,173,0,176,R,Novela%20z.%20o%20ve%u0159ejn%E9m%20zdravotn%EDm%20poji%u0161t%u011Bn%ED
52506,7,1285106400,106,65,1,1,173,A,Novela%20z.%20o%20ve%u0159ejn%E9m%20zdravotn%EDm%20poji%u0161t%u011Bn%ED
52507,62,1285106400,167,1,3,0,171,A,N%E1vrh%20na%20odvol%E1n%ED%20%u010Dlen%u016F%20a%20n%E1hradn%EDk%u016F%20SR%20VZP
52508,63,1285106400,166,1,4,1,172,A,N%E1vrh%20na%20odvol%E1n%ED%20%u010Dlena%20a%20n%E1hradn%EDka%20DR%20VZP
52509,64,1285106400,168,0,3,1,172,A,N%E1vrh%20na%20volbu%20%u010Dlen%u016F%20SR%20VZP
52510,65,1285106400,168,0,5,0,173,A,N%E1vrh%20na%20volbu%20%u010Dlen%u016F%20DR%20VZP
52511,9,1285106400,128,1,26,1,156,A,Novela%20z.%20o%20ob%u011Bhu%20osiva%20a%20sadby%20-%20EU
52512,9,1285106400,135,0,22,1,158,A,Novela%20z.%20o%20ob%u011Bhu%20osiva%20a%20sadby%20-%20EU
52513,13,1285106400,129,0,29,0,158,A,Novela%20z.%20o%20krmivech%20-%20EU
52514,14,1285106400,129,3,28,0,160,A,Novela%20z.%20o%20%u0161lecht%u011Bn%ED%2C%20plemenitb%u011B%20a%20evidenci%20hosp.%20zv%ED%u0159at%20-%20EU
52515,8,1285106400,92,49,20,5,166,A,Novela%20z.%20o%20civiln%EDm%20letectv%ED
52516,0,1285192800,89,0,16,5,110,A,Po%u0159ad%20sch%u016Fze
52517,0,1285192800,99,1,20,3,123,A,Po%u0159ad%20sch%u016Fze
52518,0,1285192800,108,2,15,3,128,A,Po%u0159ad%20sch%u016Fze
52519,88,1285192800,65,69,1,3,138,R,Odpov%u011Bdi%20%u010Dlen%u016F%20vl%E1dy%20na%20p%EDsemn%E9%20interpelace
52520,0,1285192800,160,1,3,0,164,A,%20
52521,0,1285192800,77,91,9,3,180,R,Po%u0159dad%20sch%u016Fze
52522,89,1285192800,0,0,68,0,68,R,%DAstn%ED%20interpelace
52523,89,1285192800,0,0,68,0,68,R,%DAstn%ED%20interpelace
52524,28,1285192800,104,0,18,0,122,A,Smlouva%20mezi%20%u010CR%20a%20Austr%E1li%ED%20o%20soci%E1ln%EDm%20zabezpe%u010Den%ED
52525,39,1285192800,102,0,19,0,121,A,%DAmluvy%20MOP%20o%20inspekci%20pr%E1ce%20v%20pr%u016Fm.%20a%20obch.%20a%20v%20zem%u011Bd%u011Blstv%ED
52526,39,1285192800,105,0,19,0,124,A,%DAmluvy%20MOP%20o%20inspekci%20pr%E1ce%20v%20pr%u016Fm.%20a%20obch.%20a%20v%20zem%u011Bd%u011Blstv%ED
52527,55,1285192800,106,0,20,0,126,A,Sml.%20o%20soci%E1ln%EDm%20zabezpe%u010Den%ED%20mezi%20%u010CR%20a%20Indickou%20republikou
52528,56,1285192800,111,0,17,0,128,A,Sml.%20mezi%20%u010CR%20a%20Syrskou%20arabskou%20rep.%20o%20soci%E1ln%EDm%20zabezpe%u010Den%ED
52529,27,1285192800,116,0,15,0,131,A,Protokol%20mezi%20%u010CR%20a%20Indickou%20rep.%20o%20podpo%u0159e%20a%20ochr.%20investic
52530,29,1285192800,116,0,16,0,132,A,Doh.%20mezi%20%u010CR%20a%20vl%E1dou%20%u010Cern%E9%20Hory%20o%20podpo%u0159e%20a%20ochr.%20investic
52531,30,1285192800,117,0,17,0,134,A,Prot.%20mezi%20%u010CR%20a%20Libanonskou%20rep.%20o%20podpo%u0159e%20a%20ochr.%20investic
52532,31,1285192800,114,1,17,2,134,A,Sml.%20mezi%20%u010CR%20a%20Rep.%20Srbsko%20o%20podpo%u0159e%20a%20ochr.%20investic
52533,31,1285192800,120,0,14,0,134,A,Sml.%20mezi%20%u010CR%20a%20Rep.%20Srbsko%20o%20podpo%u0159e%20a%20ochr.%20investic
52534,32,1285192800,118,0,16,1,135,A,Protokol%20mezi%20%u010CR%20a%20Rep.%20Srbsko%20o%20zamezen%ED%20dvoj%EDmu%20zdan%u011Bn%ED
52535,32,1285192800,122,0,12,0,134,A,Protokol%20mezi%20%u010CR%20a%20Rep.%20Srbsko%20o%20zamezen%ED%20dvoj%EDmu%20zdan%u011Bn%ED
52536,33,1285192800,118,0,16,0,134,A,Sml.%20mezi%20%u010CR%20a%20vl.%20%u010C%EDnsk%E9%20lid.%20rep.%20o%20zamezen%ED%20dvoj.%20zdan%u011Bn%ED
52537,34,1285192800,112,0,21,1,134,A,Doh.%20mezi%20%u010CR%20a%20Kr%E1lovstv%EDm%20Saudsk%E9%20Ar%E1bie%20o%20ochran%u011B%20investic
52538,34,1285192800,121,0,13,0,134,A,Doh.%20mezi%20%u010CR%20a%20Kr%E1lovstv%EDm%20Saudsk%E9%20Ar%E1bie%20o%20ochran%u011B%20investic
52539,35,1285192800,116,0,17,0,133,A,Prot.%20mezi%20%u010CR%20a%20Uzbeckou%20rep.%20o%20podpo%u0159e%20a%20ochran%u011B%20investic
52540,35,1285192800,116,0,18,0,134,A,Prot.%20mezi%20%u010CR%20a%20Uzbeckou%20rep.%20o%20podpo%u0159e%20a%20ochran%u011B%20investic
52541,36,1285192800,112,3,18,1,134,A,Prot.%20mezi%20%u010CR%20a%20Guatemalskou%20rep.%20o%20podpo%u0159e%20a%20ochr.%20investic
52542,36,1285192800,115,0,19,0,134,A,Prot.%20mezi%20%u010CR%20a%20Guatemalskou%20rep.%20o%20podpo%u0159e%20a%20ochr.%20investic
52543,37,1285192800,117,2,14,1,134,A,Doh.mezi%20%u010CR%20a%20Estonskou%20rep.%20o%20zm%u011Bn%u011B%20Dohody%20o%20ochr.%20investic
52544,38,1285192800,98,4,24,8,134,A,Doh.%20mezi%20%u010CR%20a%20Gruzi%ED%20o%20podpo%u0159e%20a%20ochran%u011B%20investic
52545,38,1285192800,114,0,19,1,134,A,Doh.%20mezi%20%u010CR%20a%20Gruzi%ED%20o%20podpo%u0159e%20a%20ochran%u011B%20investic
52546,41,1285192800,110,0,22,0,132,A,Doh.%20mezi%20%u010CR%20a%20vl%E1d.Bulh.rep.o%20spolup.%20proti%20trestn%E9%20%u010Din.
52547,42,1285192800,109,0,21,0,130,A,Sml.%20mezi%20%u010CR%20a%20%u0160v%FDcarskou%20konfederac%ED%20o%20p%u0159ed%E1v%E1n%ED%20osob
52548,42,1285192800,111,0,19,0,130,A,Sml.%20mezi%20%u010CR%20a%20%u0160v%FDcarskou%20konfederac%ED%20o%20p%u0159ed%E1v%E1n%ED%20osob
52549,44,1285192800,106,0,24,0,130,A,Doh.%20mezi%20%u010CR%20a%20vl%E1dou%20%C1zerb%E1jd%u017E%E1nsk%E9%20rep.%20o%20leteck%E9%20doprav%u011B
52550,45,1285192800,105,0,25,0,130,A,Sml.%20mezi%20%u010CR%20a%20SR%20o%20%FAdr%u017Eb%u011B%20a%20oprav%E1ch%20silni%u010Dn%EDch%20objekt%u016F
52551,46,1285192800,101,0,27,0,128,A,Doh.%20mezi%20%u010CR%20a%20vl%E1dou%20Arm%E9nsk%E9%20rep.%20o%20leteck%E9%20doprav%u011B
52552,47,1285192800,105,0,24,0,129,A,N%E1vrh%20na%20p%u0159%EDstup%20%u010CR%20k%20Dodatkov%E9mu%20protokolu%20k%20%DAmluv%u011B%20CMR
52553,48,1285192800,104,0,23,0,127,A,Vl.n.zm%u011Bny%20P%u0159%EDlohy%20II%20Mezin%E1rod.%FAml.%20proti%20dopingu%20ve%20sportu
52554,49,1285192800,101,0,26,0,127,A,Sml.%20mezi%20%u010CR%20a%20SR%20o%20spole%u010Dn%FDch%20st%E1tn%EDch%20hranic%EDch
52555,50,1285192800,96,3,24,3,126,A,Doh.mezi%20%u010CR%20a%20Rep.Makedonie%20o%20spolup.%20proti%20trestn%E9%20%u010Dinnosti
52556,50,1285192800,104,0,23,0,127,A,Doh.mezi%20%u010CR%20a%20Rep.Makedonie%20o%20spolup.%20proti%20trestn%E9%20%u010Dinnosti
52557,51,1285192800,106,0,23,0,129,A,Sml.%20mezi%20%u010CR%20a%20Arm%E9nskou%20rep.%20o%20p%u0159ed%E1v%E1n%ED%20a%20p%u0159eb%EDr%E1n%ED%20osob
52558,52,1285192800,104,1,23,0,128,A,Statut%20Mezin%E1rodn%ED%20agentury%20pro%20obnoviteln%E9%20zdroje%20energie
52559,52,1285192800,87,5,30,6,128,A,Statut%20Mezin%E1rodn%ED%20agentury%20pro%20obnoviteln%E9%20zdroje%20energie
52560,54,1285192800,105,0,23,0,128,A,Doh.%20mezi%20%u010CR%20a%20Marock%FDm%20kr%E1l.%20o%20podpo%u0159e%20a%20ochran%u011B%20investic
52561,0,1285279200,128,0,9,0,137,A,Po%u0159ad%20sch%u016Fze
52562,0,1285279200,104,0,30,4,138,A,Po%u0159ad%20sch%u016Fze
52563,0,1285279200,84,5,33,19,141,A,Po%u0159ad%20sch%u016Fze
52564,0,1285279200,131,0,10,7,148,A,Po%u0159ad%20sch%u016Fze
52565,0,1285279200,129,0,8,11,148,A,Po%u0159ad%20sch%u016Fze
52566,58,1285279200,121,0,27,4,152,A,N%E1vrh%20na%20zm%u011Bny%20ve%20slo%u017Een%ED%20org%E1n%u016F%20Poslaneck%E9%20sn%u011Bmovny
52567,58,1285279200,141,0,11,0,152,A,N%E1vrh%20na%20zm%u011Bny%20ve%20slo%u017Een%ED%20org%E1n%u016F%20Poslaneck%E9%20sn%u011Bmovny
52568,59,1285279200,141,0,11,1,153,A,N%E1vrh%20na%20volbu%20%u010Dlen%u016F%20do%20st%E1l%FDch%20delegac%ED%20Parlamentu
52569,59,1285279200,44,31,46,31,152,R,N%E1vrh%20na%20volbu%20%u010Dlen%u016F%20do%20st%E1l%FDch%20delegac%ED%20Parlamentu
52570,59,1285279200,123,7,12,10,152,A,N%E1vrh%20na%20volbu%20%u010Dlen%u016F%20do%20st%E1l%FDch%20delegac%ED%20Parlamentu
52571,59,1285279200,121,1,25,6,153,A,N%E1vrh%20na%20volbu%20%u010Dlen%u016F%20do%20st%E1l%FDch%20delegac%ED%20Parlamentu
52572,59,1285279200,150,0,3,0,153,A,N%E1vrh%20na%20volbu%20%u010Dlen%u016F%20do%20st%E1l%FDch%20delegac%ED%20Parlamentu
52573,59,1285279200,121,4,23,5,153,A,N%E1vrh%20na%20volbu%20%u010Dlen%u016F%20do%20st%E1l%FDch%20delegac%ED%20Parlamentu
52574,59,1285279200,123,0,26,4,153,A,N%E1vrh%20na%20volbu%20%u010Dlen%u016F%20do%20st%E1l%FDch%20delegac%ED%20Parlamentu
52575,59,1285279200,44,37,46,27,154,R,N%E1vrh%20na%20volbu%20%u010Dlen%u016F%20do%20st%E1l%FDch%20delegac%ED%20Parlamentu
52576,59,1285279200,120,0,31,3,154,A,N%E1vrh%20na%20volbu%20%u010Dlen%u016F%20do%20st%E1l%FDch%20delegac%ED%20Parlamentu
52577,59,1285279200,124,0,28,2,154,A,N%E1vrh%20na%20volbu%20%u010Dlen%u016F%20do%20st%E1l%FDch%20delegac%ED%20Parlamentu
52578,59,1285279200,120,0,29,5,154,A,N%E1vrh%20na%20volbu%20%u010Dlen%u016F%20do%20st%E1l%FDch%20delegac%ED%20Parlamentu
52579,59,1285279200,140,0,14,0,154,A,N%E1vrh%20na%20volbu%20%u010Dlen%u016F%20do%20st%E1l%FDch%20delegac%ED%20Parlamentu
52580,59,1285279200,150,0,4,0,154,A,N%E1vrh%20na%20volbu%20%u010Dlen%u016F%20do%20st%E1l%FDch%20delegac%ED%20Parlamentu
52581,59,1285279200,123,5,23,4,155,A,N%E1vrh%20na%20volbu%20%u010Dlen%u016F%20do%20st%E1l%FDch%20delegac%ED%20Parlamentu
52582,59,1285279200,101,3,30,21,155,A,N%E1vrh%20na%20volbu%20%u010Dlen%u016F%20do%20st%E1l%FDch%20delegac%ED%20Parlamentu
52583,59,1285279200,57,33,44,22,156,R,N%E1vrh%20na%20volbu%20%u010Dlen%u016F%20do%20st%E1l%FDch%20delegac%ED%20Parlamentu
52584,59,1285279200,125,0,30,1,156,A,N%E1vrh%20na%20volbu%20%u010Dlen%u016F%20do%20st%E1l%FDch%20delegac%ED%20Parlamentu
52585,59,1285279200,126,0,28,2,156,A,N%E1vrh%20na%20volbu%20%u010Dlen%u016F%20do%20st%E1l%FDch%20delegac%ED%20Parlamentu
52586,59,1285279200,125,0,29,2,156,A,N%E1vrh%20na%20volbu%20%u010Dlen%u016F%20do%20st%E1l%FDch%20delegac%ED%20Parlamentu
52587,59,1285279200,151,0,5,0,156,A,N%E1vrh%20na%20volbu%20%u010Dlen%u016F%20do%20st%E1l%FDch%20delegac%ED%20Parlamentu
52588,59,1285279200,38,42,40,36,156,R,N%E1vrh%20na%20volbu%20%u010Dlen%u016F%20do%20st%E1l%FDch%20delegac%ED%20Parlamentu
52589,59,1285279200,125,0,28,4,157,A,N%E1vrh%20na%20volbu%20%u010Dlen%u016F%20do%20st%E1l%FDch%20delegac%ED%20Parlamentu
52590,59,1285279200,125,0,29,3,157,A,N%E1vrh%20na%20volbu%20%u010Dlen%u016F%20do%20st%E1l%FDch%20delegac%ED%20Parlamentu
52591,59,1285279200,128,0,27,2,157,A,N%E1vrh%20na%20volbu%20%u010Dlen%u016F%20do%20st%E1l%FDch%20delegac%ED%20Parlamentu
52592,59,1285279200,114,0,37,1,152,A,N%E1vrh%20na%20volbu%20%u010Dlen%u016F%20do%20st%E1l%FDch%20delegac%ED%20Parlamentu
52593,59,1285279200,117,0,35,0,152,A,N%E1vrh%20na%20volbu%20%u010Dlen%u016F%20do%20st%E1l%FDch%20delegac%ED%20Parlamentu
52594,66,1285279200,135,0,18,1,154,A,N%E1vrh%20na%20volbu%20%u010Dlena%20Nejvy%u0161%u0161%EDho%20kontroln%EDho%20%FA%u0159adu
52595,68,1285279200,118,0,33,1,152,A,N%E1vrh%20harmonogramu%20projedn%E1v%E1n%ED%20SR%202011
52596,19,1285279200,36,59,46,11,152,R,Novela%20z.%20o%20urychlen%ED%20v%FDstavby%20dopravn%ED%20infrastruktury
52597,19,1285279200,130,1,21,0,152,A,Novela%20z.%20o%20urychlen%ED%20v%FDstavby%20dopravn%ED%20infrastruktury
52598,19,1285279200,124,6,21,1,152,A,Novela%20z.%20o%20urychlen%ED%20v%FDstavby%20dopravn%ED%20infrastruktury
52599,19,1285279200,120,11,18,3,152,A,Novela%20z.%20o%20urychlen%ED%20v%FDstavby%20dopravn%ED%20infrastruktury
52600,19,1285279200,132,0,17,3,152,A,Novela%20z.%20o%20urychlen%ED%20v%FDstavby%20dopravn%ED%20infrastruktury
52601,20,1285279200,126,1,25,0,152,A,Novela%20z.%20o%20pozemn%EDch%20komunikac%EDch
52602,20,1285279200,125,0,26,1,152,A,Novela%20z.%20o%20pozemn%EDch%20komunikac%EDch
52603,21,1285279200,127,0,18,0,145,A,Novela%20z.%20o%20provozu%20na%20pozemn%EDch%20komunikac%EDch
52604,21,1285279200,94,12,34,7,147,A,Novela%20z.%20o%20provozu%20na%20pozemn%EDch%20komunikac%EDch
52605,91,1285279200,85,0,50,13,148,A,Novela%20z.%20o%20ve%u0159ejn%FDch%20zak%E1zk%E1ch
52606,91,1285279200,7,14,124,3,148,R,Novela%20z.%20o%20ve%u0159ejn%FDch%20zak%E1zk%E1ch
52607,91,1285279200,16,81,46,5,148,R,Novela%20z.%20o%20ve%u0159ejn%FDch%20zak%E1zk%E1ch
52608,91,1285279200,87,5,40,17,149,A,Novela%20z.%20o%20ve%u0159ejn%FDch%20zak%E1zk%E1ch
52609,22,1285279200,111,0,0,1,112,A,Novela%20z.%20o%20%u010Cesk%E9%20televizi
52610,22,1285279200,113,0,0,0,113,A,Novela%20z.%20o%20%u010Cesk%E9%20televizi
52611,0,1285279200,80,22,7,3,112,A,%20
52612,0,1288044000,146,0,18,0,164,A,%20
52613,0,1288044000,108,1,35,34,178,A,Po%u0159ad%20sch%u016Fze
52614,0,1288044000,98,28,18,35,179,A,Po%u0159ad%20sch%u016Fze
52615,0,1288044000,100,56,10,13,179,A,Po%u0159ad%20sch%u016Fze
52616,0,1288044000,101,9,32,37,179,A,Po%u0159ad%20sch%u016Fze
52617,1,1288044000,171,0,12,0,183,A,Novela%20z.%20o%20stavebn%EDm%20spo%u0159en%ED
52618,5,1288130400,44,17,101,4,166,R,Vl.%20n.%20z.%20o%20st%E1tn%EDm%20rozpo%u010Dtu%20%u010CR%20na%20rok%202011
52619,5,1288130400,145,26,3,0,174,A,Vl.%20n.%20z.%20o%20st%E1tn%EDm%20rozpo%u010Dtu%20%u010CR%20na%20rok%202011
52620,5,1288130400,109,70,0,0,179,A,Vl.%20n.%20z.%20o%20st%E1tn%EDm%20rozpo%u010Dtu%20%u010CR%20na%20rok%202011
52621,0,1288303200,149,0,7,1,157,A,Po%u0159ad%20sch%u016Fze
52622,21,1288303200,162,2,4,0,168,A,Novela%20z.%20o%20platu%20p%u0159edstavitel%u016F%20st%E1tn%ED%20moci
52623,21,1288303200,134,9,20,4,167,A,Novela%20z.%20o%20platu%20p%u0159edstavitel%u016F%20st%E1tn%ED%20moci
52624,21,1288303200,137,12,11,8,168,A,Novela%20z.%20o%20platu%20p%u0159edstavitel%u016F%20st%E1tn%ED%20moci
52625,18,1288303200,6,0,165,0,171,R,Novela%20z.%20o%20podpo%u0159e%20vyu%u017E%EDv%E1n%ED%20obnoviteln%FDch%20zdroj%u016F
52626,18,1288303200,162,0,9,2,173,A,Novela%20z.%20o%20podpo%u0159e%20vyu%u017E%EDv%E1n%ED%20obnoviteln%FDch%20zdroj%u016F
52627,18,1288303200,162,0,9,2,173,A,Novela%20z.%20o%20podpo%u0159e%20vyu%u017E%EDv%E1n%ED%20obnoviteln%FDch%20zdroj%u016F
52628,19,1288303200,92,1,80,0,173,A,Novela%20z.%20o%20podpo%u0159e%20vyu%u017E%EDv%E1n%ED%20obnoviteln%FDch%20zdroj%u016F
52629,19,1288303200,162,1,10,0,173,A,Novela%20z.%20o%20podpo%u0159e%20vyu%u017E%EDv%E1n%ED%20obnoviteln%FDch%20zdroj%u016F
52630,19,1288303200,47,70,22,34,173,R,Novela%20z.%20o%20podpo%u0159e%20vyu%u017E%EDv%E1n%ED%20obnoviteln%FDch%20zdroj%u016F
52631,19,1288303200,136,0,31,6,173,A,Novela%20z.%20o%20podpo%u0159e%20vyu%u017E%EDv%E1n%ED%20obnoviteln%FDch%20zdroj%u016F
52632,12,1288303200,71,0,31,0,102,A,Novela%20z.%20o%20pozemn%EDch%20komunikac%EDch
52633,12,1288303200,97,0,9,5,111,A,Novela%20z.%20o%20pozemn%EDch%20komunikac%EDch
52634,59,1288303200,104,0,19,0,123,A,Ro%u010Dn%ED%20%FA%u010Detn%ED%20z%E1v%u011Brka%20a%20v%FDro%u010Dn%ED%20zpr%E1va%20SFRB%20za%20rok%202008
52635,60,1288303200,116,0,15,0,131,A,Ro%u010Dn%ED%20%FA%u010Detn%ED%20z%E1v%u011Brka%20a%20v%FDro%u010Dn%ED%20zpr%E1va%20SFRB%20za%20rok%202009
52636,61,1288303200,45,78,3,4,130,R,N%E1vrh%20st%E1tn%EDho%20z%E1v%u011Bre%u010Dn%E9ho%20%FA%u010Dtu%20%u010CR%20za%20rok%202009
52637,61,1288303200,89,1,16,25,131,A,N%E1vrh%20st%E1tn%EDho%20z%E1v%u011Bre%u010Dn%E9ho%20%FA%u010Dtu%20%u010CR%20za%20rok%202009
52638,0,1288652400,146,0,7,2,155,A,%20
52639,0,1288652400,74,103,3,1,181,R,Po%u0159ad%20sch%u016Fze
52640,0,1288652400,72,43,37,30,182,R,%20
52641,0,1288652400,104,68,8,2,182,A,%20
52642,0,1288652400,105,46,0,0,151,A,Po%u0159ad%20sch%u016Fze
52643,0,1288652400,106,47,0,0,153,A,Po%u0159ad%20sch%u016Fze
52644,1,1288652400,90,39,5,0,134,A,Vl.n.z.%20v%20souvislosti%20s%20%FAsporn%FDmi%20opat%u0159en%EDmi%20v%20p%u016Fsob.%20MPSV
52645,1,1288652400,40,16,64,26,146,R,Vl.n.z.%20v%20souvislosti%20s%20%FAsporn%FDmi%20opat%u0159en%EDmi%20v%20p%u016Fsob.%20MPSV
52646,1,1288652400,106,48,2,0,156,A,Vl.n.z.%20v%20souvislosti%20s%20%FAsporn%FDmi%20opat%u0159en%EDmi%20v%20p%u016Fsob.%20MPSV
52647,1,1288652400,8,3,145,0,156,R,Vl.n.z.%20v%20souvislosti%20s%20%FAsporn%FDmi%20opat%u0159en%EDmi%20v%20p%u016Fsob.%20MPSV
52648,1,1288652400,49,103,2,2,156,R,Vl.n.z.%20v%20souvislosti%20s%20%FAsporn%FDmi%20opat%u0159en%EDmi%20v%20p%u016Fsob.%20MPSV
52649,1,1288652400,149,3,2,2,156,A,Vl.n.z.%20v%20souvislosti%20s%20%FAsporn%FDmi%20opat%u0159en%EDmi%20v%20p%u016Fsob.%20MPSV
52650,1,1288652400,152,3,0,1,156,A,Vl.n.z.%20v%20souvislosti%20s%20%FAsporn%FDmi%20opat%u0159en%EDmi%20v%20p%u016Fsob.%20MPSV
52651,1,1288652400,48,106,2,0,156,R,Vl.n.z.%20v%20souvislosti%20s%20%FAsporn%FDmi%20opat%u0159en%EDmi%20v%20p%u016Fsob.%20MPSV
52652,1,1288652400,48,106,2,0,156,R,Vl.n.z.%20v%20souvislosti%20s%20%FAsporn%FDmi%20opat%u0159en%EDmi%20v%20p%u016Fsob.%20MPSV
52653,1,1288652400,48,106,2,0,156,R,Vl.n.z.%20v%20souvislosti%20s%20%FAsporn%FDmi%20opat%u0159en%EDmi%20v%20p%u016Fsob.%20MPSV
52654,1,1288652400,108,47,0,1,156,A,Vl.n.z.%20v%20souvislosti%20s%20%FAsporn%FDmi%20opat%u0159en%EDmi%20v%20p%u016Fsob.%20MPSV
52655,2,1288652400,102,41,11,0,154,A,Novela%20z.%20o%20sdru%u017Eov%E1n%ED%20v%20politick%FDch%20stran%E1ch%20a%20hnut%EDch
52656,2,1288652400,130,1,20,0,151,A,Novela%20z.%20o%20sdru%u017Eov%E1n%ED%20v%20politick%FDch%20stran%E1ch%20a%20hnut%EDch
52657,2,1288652400,44,98,6,0,148,R,Novela%20z.%20o%20sdru%u017Eov%E1n%ED%20v%20politick%FDch%20stran%E1ch%20a%20hnut%EDch
52658,2,1288652400,99,42,5,1,147,A,Novela%20z.%20o%20sdru%u017Eov%E1n%ED%20v%20politick%FDch%20stran%E1ch%20a%20hnut%EDch
52659,3,1288652400,97,43,6,0,146,A,Novela%20z.%20o%20stavebn%EDm%20spo%u0159en%ED
52660,3,1288652400,130,3,12,1,146,A,Novela%20z.%20o%20stavebn%EDm%20spo%u0159en%ED
52661,3,1288652400,43,95,6,0,144,R,Novela%20z.%20o%20stavebn%EDm%20spo%u0159en%ED
52662,3,1288652400,46,90,8,0,144,R,Novela%20z.%20o%20stavebn%EDm%20spo%u0159en%ED
52663,3,1288652400,96,44,4,0,144,A,Novela%20z.%20o%20stavebn%EDm%20spo%u0159en%ED
52664,4,1288652400,96,44,5,0,145,A,Novela%20z.%20o%20dan%EDch%20z%20p%u0159%EDjm%u016F
52665,4,1288652400,134,3,7,2,146,A,Novela%20z.%20o%20dan%EDch%20z%20p%u0159%EDjm%u016F
52666,4,1288652400,102,41,1,1,145,A,Novela%20z.%20o%20dan%EDch%20z%20p%u0159%EDjm%u016F
52667,4,1288652400,103,40,0,2,145,A,Novela%20z.%20o%20dan%EDch%20z%20p%u0159%EDjm%u016F
52668,0,1288738800,87,24,23,19,153,A,Po%u0159ad%20sch%u016Fze
52669,0,1288738800,138,6,9,3,156,A,Po%u0159ad%20sch%u016Fze
52670,0,1288738800,89,15,28,27,159,A,Po%u0159ad%20sch%u016Fze
52671,0,1288738800,114,10,11,25,160,A,Po%u0159ad%20sch%u016Fze
52672,83,1288738800,106,67,2,7,182,A,Vl.n.p%u016Fsob.sil%20MO%20%u010CR%20v%20zahr.operac%EDch%20v%20letech%202011%20a%202012
52673,83,1288738800,100,45,27,11,183,A,Vl.n.p%u016Fsob.sil%20MO%20%u010CR%20v%20zahr.operac%EDch%20v%20letech%202011%20a%202012
52674,83,1288738800,128,27,26,2,183,A,Vl.n.p%u016Fsob.sil%20MO%20%u010CR%20v%20zahr.operac%EDch%20v%20letech%202011%20a%202012
52675,83,1288738800,56,28,82,18,184,R,Vl.n.p%u016Fsob.sil%20MO%20%u010CR%20v%20zahr.operac%EDch%20v%20letech%202011%20a%202012
52676,41,1288738800,123,2,55,4,184,A,Prot.%20o%20p%u0159echodn%FDch%20ustanoven%EDch%20ke%20Smlouv%u011B%20o%20Evropsk%E9%20unii
52677,43,1288738800,145,0,36,0,181,A,Doh.o%20stabilizaci%20a%20p%u0159idru%u017Een%ED%20mezi%20ES%20a%20Rep.Srbsko
52678,13,1288738800,139,0,38,0,177,A,Novela%20z.%20v%20souvislosti%20se%20stanoven%EDm%20kapit%E1lov%FDch%20po%u017Eadavk%u016F%20-%20EU
52679,13,1288738800,137,1,38,1,177,A,Novela%20z.%20v%20souvislosti%20se%20stanoven%EDm%20kapit%E1lov%FDch%20po%u017Eadavk%u016F%20-%20EU
52680,22,1288738800,81,4,58,34,177,R,Vl.n.z.%20o%20st%E1tn%EDm%20dluhopisov%E9m%20programu
52681,22,1288738800,116,6,16,8,146,A,Vl.n.z.%20o%20st%E1tn%EDm%20dluhopisov%E9m%20programu
52682,22,1288738800,89,7,25,28,149,A,Vl.n.z.%20o%20st%E1tn%EDm%20dluhopisov%E9m%20programu
52683,22,1288738800,91,5,26,32,154,A,Vl.n.z.%20o%20st%E1tn%EDm%20dluhopisov%E9m%20programu
52684,23,1288738800,137,0,21,0,158,A,Novela%20z.%20o%20spot%u0159ebn%EDch%20dan%EDch%20-%20EU
52685,88,1288738800,25,96,35,12,168,R,Novela%20z.%20o%20podpo%u0159e%20vyu%u017E%EDv%E1n%ED%20obnoviteln%FDch%20zdroj%u016F
52686,88,1288738800,156,2,9,6,173,A,Novela%20z.%20o%20podpo%u0159e%20vyu%u017E%EDv%E1n%ED%20obnoviteln%FDch%20zdroj%u016F
52687,24,1288738800,150,0,19,0,169,A,Novela%20z.%20o%20dani%20z%20p%u0159idan%E9%20hodnoty%20-%20EU
52688,24,1288738800,153,0,17,0,170,A,Novela%20z.%20o%20dani%20z%20p%u0159idan%E9%20hodnoty%20-%20EU
52689,14,1288738800,128,0,39,0,167,A,Novela%20z.%20o%20dr%E1h%E1ch%20-%20EU
52690,25,1288738800,127,0,40,0,167,A,Novela%20celn%EDho%20z%E1kona%20-%20EU
52691,0,1288825200,58,28,22,4,112,A,Po%u0159ad%20sch%u016Fze
52692,0,1288825200,111,0,2,0,113,A,Po%u0159ad%20sch%u016Fze
52693,0,1288825200,58,38,12,5,113,A,Po%u0159ad%20sch%u016Fze
52694,0,1288825200,108,3,2,1,114,A,Po%u0159ad%20sch%u016Fze
52695,82,1288825200,120,1,29,0,150,A,Souhr.zpr%E1va%20o%20%u010Dinnosti%20ve%u0159ejn%E9ho%20ochr%E1nce%20pr%E1v%20za%20rok%202009
52696,68,1288825200,112,1,2,1,116,A,Inf.%20o%20realizaci%20protipovod%u0148ov%FDch%20opat%u0159en%ED%20v%20%u010CR%20za%20rok%202009
52697,69,1288825200,106,1,21,0,128,A,Zpr%E1va%20o%20stavu%20zem%u011Bd%u011Blstv%ED%20%u010CR%20za%20rok%202009
52698,70,1288825200,106,2,24,0,132,A,V%FDro%u010Dn%ED%20zpr%E1va%20o%20%u010Dinnosti%20Pozemkov%E9ho%20fondu%20%u010CR%20za%20rok%202009
52699,71,1288825200,115,2,22,0,139,A,N%E1vrh%20I.%20zm%u011Bny%20rozpo%u010Dtu%20Pozemkov%E9ho%20fondu%20%u010CR%20na%20rok%202010
52700,17,1288825200,120,1,25,0,146,A,Novela%20z.%20o%20ochran%u011B%20ovzdu%u0161%ED
52701,17,1288825200,53,37,42,14,146,R,Novela%20z.%20o%20ochran%u011B%20ovzdu%u0161%ED
52702,17,1288825200,123,1,21,2,147,A,Novela%20z.%20o%20ochran%u011B%20ovzdu%u0161%ED
52703,42,1288825200,88,0,41,0,129,A,%DAmluva%20o%20pou%u017E%EDv%E1n%ED%20informa%u010Dn%ED%20technologie%20pro%20celn%ED%20%FA%u010Dely
52704,44,1288825200,93,0,2,0,95,A,Prot.%20mezi%20%u010CR%20a%20Belgick%FDm%20kr%E1l.%20o%20zamezen%ED%20dvoj%EDho%20zdan%u011Bn%ED
52705,45,1288825200,90,1,9,0,100,A,Vl.n.%20k%20souhlasu%20s%20ratifikac%ED%20Memoranda%20o%20porozum%u011Bn%ED
52706,45,1288825200,98,0,2,0,100,A,Vl.n.%20k%20souhlasu%20s%20ratifikac%ED%20Memoranda%20o%20porozum%u011Bn%ED
52707,46,1288825200,96,0,4,0,100,A,Doh.%20o%20leteck%E9%20doprav%u011B%20mezi%20st%E1ty%20ES%20a%20Kanadou
52708,46,1288825200,97,0,2,0,99,A,Doh.%20o%20leteck%E9%20doprav%u011B%20mezi%20st%E1ty%20ES%20a%20Kanadou
52709,47,1288825200,96,0,5,0,101,A,Prot.%20o%20zm%u011Bn%u011B%20Doh.%20mezi%20st%E1ty%20ES%20a%20USA%20o%20leteck%E9%20doprav%u011B
52710,47,1288825200,101,0,1,0,102,A,Prot.%20o%20zm%u011Bn%u011B%20Doh.%20mezi%20st%E1ty%20ES%20a%20USA%20o%20leteck%E9%20doprav%u011B
52711,48,1288825200,101,0,3,0,104,A,Prot.%20o%20perzistentn%EDch%20organick%FDch%20polutantech
52712,49,1288825200,100,0,4,0,104,A,Sml.mezi%20%u010CR%20a%20vl.%20%u010Cern%E9%20Hory%20o%20v%FDm%u011Bn%u011B%20a%20ochr.%20utaj.informac%ED
52713,50,1288825200,96,0,8,0,104,A,Sml.mezi%20%u010CR%20a%20vl.%20Rumunska%20o%20vz%E1jemn%E9%20ochran%u011B%20utaj.informac%ED
52714,50,1288825200,100,0,4,0,104,A,Sml.mezi%20%u010CR%20a%20vl.%20Rumunska%20o%20vz%E1jemn%E9%20ochran%u011B%20utaj.informac%ED
52715,51,1288825200,99,0,5,0,104,A,Sml.mezi%20%u010CR%20a%20Bosnou%20a%20Herc.o%20v%FDm%u011Bn%u011B%20a%20ochr.%20utaj.%20informac%ED
52716,63,1288825200,73,2,22,0,97,A,Informace%20o%20podpo%u0159en%E9m%20financov%E1n%ED%20za%20rok%202009
52717,63,1288825200,85,0,15,0,100,A,Informace%20o%20podpo%u0159en%E9m%20financov%E1n%ED%20za%20rok%202009
52718,64,1288825200,91,0,12,0,103,A,Inf.%20o%20poji%u0161%u0165ov%E1n%ED%20v%FDvozu%20se%20st%E1tn%ED%20podporou%20%281%20-%2012/2009%29
52719,65,1288825200,94,0,8,0,102,A,V%FDro%u010Dn%ED%20zpr%E1va%20%u010Cesk%E9ho%20telekomunika%u010Dn%EDho%20%FA%u0159adu%20za%20rok%202009
52720,62,1288825200,60,6,21,16,103,A,P%u0159ehled%20o%20%u010Dinnosti%20cenov%FDch%20kontroln%EDch%20org%E1n%u016F%20za%20rok%202009
52721,66,1288825200,81,0,5,5,91,A,Strategie%20boje%20proti%20extremismu%20v%20roce%202009
52722,0,1288911600,77,56,5,1,139,A,Po%u0159ad%20sch%u016Fze
52723,0,1288911600,130,1,7,2,140,A,Po%u0159ad%20sch%u016Fze
52724,0,1288911600,104,3,11,25,143,A,Po%u0159ad%20sch%u016Fze
52725,0,1288911600,140,1,3,1,145,A,Po%u0159ad%20sch%u016Fze
52726,0,1288911600,143,0,3,1,147,A,Po%u0159ad%20sch%u016Fze
52727,53,1288911600,140,0,10,1,151,A,Novela%20z.%20o%20krizov%E9m%20%u0159%EDzen%ED%20-%20EU
52728,53,1288911600,134,0,11,6,151,A,Novela%20z.%20o%20krizov%E9m%20%u0159%EDzen%ED%20-%20EU
52729,57,1288911600,109,2,15,27,153,A,Novela%20z.%20o%20z%E1kladn%EDch%20registrech
52730,57,1288911600,106,3,15,29,153,A,Novela%20z.%20o%20z%E1kladn%EDch%20registrech
52731,57,1288911600,109,2,13,29,153,A,Novela%20z.%20o%20z%E1kladn%EDch%20registrech
52732,57,1288911600,100,0,22,31,153,A,Novela%20z.%20o%20z%E1kladn%EDch%20registrech
52733,57,1288911600,100,21,18,15,154,A,Novela%20z.%20o%20z%E1kladn%EDch%20registrech
52734,57,1288911600,103,11,23,17,154,A,Novela%20z.%20o%20z%E1kladn%EDch%20registrech
52735,52,1288911600,128,0,16,8,152,A,Novela%20z.%20o%20%FA%u010Detnictv%ED%20-%20EU
52736,52,1288911600,136,1,12,4,153,A,Novela%20z.%20o%20%FA%u010Detnictv%ED%20-%20EU
52737,54,1288911600,130,0,18,2,150,A,Vl.n.z.%20o%20finan%u010Dn%EDm%20zaji%u0161t%u011Bn%ED%20-%20EU
52738,55,1288911600,130,0,21,2,153,A,Vl.n.z.%20o%20zm%u011Bn%u011B%20z%E1kon%u016F%20v%20souvisl.%20s%20p%u0159ij.%20z%E1k.o%20fin.zaji%u0161t%u011Bn%ED%20-%20EU
52739,55,1288911600,129,2,20,2,153,A,Vl.n.z.%20o%20zm%u011Bn%u011B%20z%E1kon%u016F%20v%20souvisl.%20s%20p%u0159ij.%20z%E1k.o%20fin.zaji%u0161t%u011Bn%ED%20-%20EU
52740,55,1288911600,133,0,18,2,153,A,Vl.n.z.%20o%20zm%u011Bn%u011B%20z%E1kon%u016F%20v%20souvisl.%20s%20p%u0159ij.%20z%E1k.o%20fin.zaji%u0161t%u011Bn%ED%20-%20EU
52741,55,1288911600,134,0,16,3,153,A,Vl.n.z.%20o%20zm%u011Bn%u011B%20z%E1kon%u016F%20v%20souvisl.%20s%20p%u0159ij.%20z%E1k.o%20fin.zaji%u0161t%u011Bn%ED%20-%20EU
52742,58,1288911600,108,0,41,2,151,A,Novela%20z.%20o%20pozemn%EDch%20komunikac%EDch
52743,58,1288911600,134,1,14,3,152,A,Novela%20z.%20o%20pozemn%EDch%20komunikac%EDch
52744,20,1288911600,64,73,4,1,142,R,N.z.%20o%20%DA%u0159adu%20pr%E1ce%20%u010Cesk%E9%20republiky
52745,20,1288911600,59,75,7,0,141,R,N.z.%20o%20%DA%u0159adu%20pr%E1ce%20%u010Cesk%E9%20republiky
52746,20,1288911600,135,0,5,1,141,A,N.z.%20o%20%DA%u0159adu%20pr%E1ce%20%u010Cesk%E9%20republiky
52747,20,1288911600,81,57,3,0,141,A,N.z.%20o%20%DA%u0159adu%20pr%E1ce%20%u010Cesk%E9%20republiky
52748,15,1288911600,93,0,12,6,111,A,Novela%20z.%20o%20hlavn%EDm%20m%u011Bst%u011B%20Praze
52749,15,1288911600,69,55,2,0,126,A,Novela%20z.%20o%20hlavn%EDm%20m%u011Bst%u011B%20Praze
52750,16,1288911600,112,2,13,1,128,A,Novela%20z.%20o%20civiln%EDm%20letectv%ED
52751,16,1288911600,113,2,13,0,128,A,Novela%20z.%20o%20civiln%EDm%20letectv%ED
52752,56,1289257200,161,1,5,1,168,A,Novela%20z.%20o%20pobytu%20cizinc%u016F%20na%20%FAzem%ED%20%u010CR
52753,56,1289257200,158,1,7,2,168,A,Novela%20z.%20o%20pobytu%20cizinc%u016F%20na%20%FAzem%ED%20%u010CR
52754,56,1289257200,162,2,4,0,168,A,Novela%20z.%20o%20pobytu%20cizinc%u016F%20na%20%FAzem%ED%20%u010CR
52755,56,1289257200,102,58,2,6,168,A,Novela%20z.%20o%20pobytu%20cizinc%u016F%20na%20%FAzem%ED%20%u010CR
52756,56,1289257200,102,16,22,28,168,A,Novela%20z.%20o%20pobytu%20cizinc%u016F%20na%20%FAzem%ED%20%u010CR
52757,56,1289257200,157,3,6,2,168,A,Novela%20z.%20o%20pobytu%20cizinc%u016F%20na%20%FAzem%ED%20%u010CR
52758,56,1289257200,144,1,18,6,169,A,Novela%20z.%20o%20pobytu%20cizinc%u016F%20na%20%FAzem%ED%20%u010CR
52759,56,1289257200,168,1,0,0,169,A,Novela%20z.%20o%20pobytu%20cizinc%u016F%20na%20%FAzem%ED%20%u010CR
52760,56,1289257200,13,113,16,27,169,R,Novela%20z.%20o%20pobytu%20cizinc%u016F%20na%20%FAzem%ED%20%u010CR
52761,56,1289257200,62,94,5,8,169,R,Novela%20z.%20o%20pobytu%20cizinc%u016F%20na%20%FAzem%ED%20%u010CR
52762,56,1289257200,61,94,9,5,169,R,Novela%20z.%20o%20pobytu%20cizinc%u016F%20na%20%FAzem%ED%20%u010CR
52763,56,1289257200,63,102,1,3,169,R,Novela%20z.%20o%20pobytu%20cizinc%u016F%20na%20%FAzem%ED%20%u010CR
52764,56,1289257200,62,102,3,2,169,R,Novela%20z.%20o%20pobytu%20cizinc%u016F%20na%20%FAzem%ED%20%u010CR
52765,56,1289257200,105,36,17,11,169,A,Novela%20z.%20o%20pobytu%20cizinc%u016F%20na%20%FAzem%ED%20%u010CR
52766,56,1289257200,67,100,1,1,169,R,Novela%20z.%20o%20pobytu%20cizinc%u016F%20na%20%FAzem%ED%20%u010CR
52767,56,1289257200,65,100,2,2,169,R,Novela%20z.%20o%20pobytu%20cizinc%u016F%20na%20%FAzem%ED%20%u010CR
52768,56,1289257200,67,96,5,2,170,R,Novela%20z.%20o%20pobytu%20cizinc%u016F%20na%20%FAzem%ED%20%u010CR
52769,56,1289257200,104,32,20,13,169,A,Novela%20z.%20o%20pobytu%20cizinc%u016F%20na%20%FAzem%ED%20%u010CR
52770,89,1289257200,15,101,30,10,156,R,Novela%20z.%20o%20podpo%u0159e%20vyu%u017E%EDv%E1n%ED%20obnoviteln%FDch%20zdroj%u016F
52771,89,1289257200,153,1,3,4,161,A,Novela%20z.%20o%20podpo%u0159e%20vyu%u017E%EDv%E1n%ED%20obnoviteln%FDch%20zdroj%u016F
52772,89,1289257200,26,56,65,15,162,R,Novela%20z.%20o%20podpo%u0159e%20vyu%u017E%EDv%E1n%ED%20obnoviteln%FDch%20zdroj%u016F
52773,89,1289257200,51,20,86,5,162,R,Novela%20z.%20o%20podpo%u0159e%20vyu%u017E%EDv%E1n%ED%20obnoviteln%FDch%20zdroj%u016F
52774,89,1289257200,47,14,96,6,163,R,Novela%20z.%20o%20podpo%u0159e%20vyu%u017E%EDv%E1n%ED%20obnoviteln%FDch%20zdroj%u016F
52775,89,1289257200,56,88,13,5,162,R,Novela%20z.%20o%20podpo%u0159e%20vyu%u017E%EDv%E1n%ED%20obnoviteln%FDch%20zdroj%u016F
52776,89,1289257200,60,82,15,5,162,R,Novela%20z.%20o%20podpo%u0159e%20vyu%u017E%EDv%E1n%ED%20obnoviteln%FDch%20zdroj%u016F
52777,89,1289257200,55,86,17,4,162,R,Novela%20z.%20o%20podpo%u0159e%20vyu%u017E%EDv%E1n%ED%20obnoviteln%FDch%20zdroj%u016F
52778,89,1289257200,36,96,11,19,162,R,Novela%20z.%20o%20podpo%u0159e%20vyu%u017E%EDv%E1n%ED%20obnoviteln%FDch%20zdroj%u016F
52779,89,1289257200,61,80,11,12,164,R,Novela%20z.%20o%20podpo%u0159e%20vyu%u017E%EDv%E1n%ED%20obnoviteln%FDch%20zdroj%u016F
52780,89,1289257200,132,10,11,11,164,A,Novela%20z.%20o%20podpo%u0159e%20vyu%u017E%EDv%E1n%ED%20obnoviteln%FDch%20zdroj%u016F
52781,89,1289257200,123,12,10,14,159,A,Novela%20z.%20o%20podpo%u0159e%20vyu%u017E%EDv%E1n%ED%20obnoviteln%FDch%20zdroj%u016F
52782,0,1289257200,93,37,14,10,154,A,%20
52783,0,1291676400,146,0,16,0,162,A,%20
52784,0,1291676400,151,3,24,4,182,A,Po%u0159ad%20sch%u016Fze
52785,0,1291676400,146,3,30,4,183,A,Po%u0159ad%20sch%u016Fze
52786,0,1291676400,146,4,28,5,183,A,Po%u0159ad%20sch%u016Fze
52787,0,1291676400,149,6,7,22,184,A,Po%u0159ad%20sch%u016Fze
52788,0,1291676400,147,1,30,6,184,A,Po%u0159ad%20sch%u016Fze
52789,0,1291676400,69,57,31,27,184,R,Po%u0159ad%20sch%u016Fze
52790,0,1291676400,115,32,16,23,186,A,Po%u0159ad%20sch%u016Fze
52791,0,1291676400,75,96,7,8,186,R,Po%u0159ad%20sch%u016Fze
52792,0,1291676400,140,0,34,12,186,A,Po%u0159ad%20sch%u016Fze
52793,0,1291676400,104,4,42,36,186,A,Po%u0159ad%20sch%u016Fze
52794,0,1291676400,105,38,34,9,186,A,Po%u0159ad%20sch%u016Fze
52795,0,1291676400,112,40,19,15,186,A,Po%u0159ad%20sch%u016Fze
52796,2,1291676400,166,0,16,3,185,A,Novela%20z.%20o%20ve%u0159ejn%FDch%20zak%E1zk%E1ch
52797,2,1291676400,2,87,59,36,184,R,Novela%20z.%20o%20ve%u0159ejn%FDch%20zak%E1zk%E1ch
52798,2,1291676400,151,0,33,1,185,A,Novela%20z.%20o%20ve%u0159ejn%FDch%20zak%E1zk%E1ch
52799,3,1291676400,94,10,52,21,177,A,Novela%20z.%20o%20platu%20p%u0159edstavitel%u016F%20st%E1tn%ED%20moci
52800,4,1291676400,115,6,6,7,134,A,Novela%20z.%20o%20krmivech%20-%20EU
52801,9,1291676400,106,1,38,1,146,A,Novela%20z.%20o%20ochran%u011B%20ovzdu%u0161%ED
52802,14,1291676400,147,0,12,1,160,A,Novela%20z.%20o%20st%u0159etu%20z%E1jm%u016F
52803,14,1291676400,69,39,38,16,162,R,Novela%20z.%20o%20st%u0159etu%20z%E1jm%u016F
52804,15,1291676400,95,1,5,2,103,A,Novela%20z.%20-%20da%u0148ov%FD%20%u0159%E1d
52805,15,1291676400,92,18,25,10,145,A,Novela%20z.%20-%20da%u0148ov%FD%20%u0159%E1d
52806,15,1291676400,97,0,55,3,155,A,Novela%20z.%20-%20da%u0148ov%FD%20%u0159%E1d
52807,15,1291676400,113,0,39,4,156,A,Novela%20z.%20-%20da%u0148ov%FD%20%u0159%E1d
52808,15,1291676400,132,0,27,2,161,A,Novela%20z.%20-%20da%u0148ov%FD%20%u0159%E1d
52809,17,1291676400,129,0,27,0,156,A,Vl.n.z.%20o%20st%E1tn%EDm%20dluhopisov%E9m%20programu
52810,17,1291676400,76,32,42,6,156,R,Vl.n.z.%20o%20st%E1tn%EDm%20dluhopisov%E9m%20programu
52811,17,1291676400,111,7,16,3,137,A,Vl.n.z.%20o%20st%E1tn%EDm%20dluhopisov%E9m%20programu
52812,17,1291676400,87,41,16,2,146,A,Vl.n.z.%20o%20st%E1tn%EDm%20dluhopisov%E9m%20programu
52813,18,1291676400,133,0,11,0,144,A,Novela%20z.%20o%20technick%FDch%20po%u017Eadavc%EDch%20na%20v%FDrobky%20-%20EU
52814,18,1291676400,95,12,32,5,144,A,Novela%20z.%20o%20technick%FDch%20po%u017Eadavc%EDch%20na%20v%FDrobky%20-%20EU
52815,0,1291762800,94,5,36,15,150,A,Po%u0159ad%20sch%u016Fze
52816,0,1291762800,91,11,42,12,156,A,Po%u0159ad%20sch%u016Fze
52817,0,1291762800,133,4,20,1,158,A,Po%u0159ad%20sch%u016Fze
52818,0,1291762800,107,3,35,15,160,A,Po%u0159ad%20sch%u016Fze
52819,83,1291762800,125,0,42,0,167,A,Doh.mezi%20ES%20a%20Jihoafric.rep.o%20obchodu%2Crozvoji%20a%20spolupr%E1ci
52820,90,1291762800,130,0,43,0,173,A,Doh.%20o%20v%FDsad%E1ch%20a%20imunit%E1ch%20Mez.%20trest.%20soudu
52821,24,1291762800,129,1,44,3,177,A,Novela%20z.%20-%20ob%u010Dansk%FD%20z%E1kon%EDk%20-%20EU
52822,24,1291762800,60,49,48,19,176,R,Novela%20z.%20-%20ob%u010Dansk%FD%20z%E1kon%EDk%20-%20EU
52823,24,1291762800,90,51,3,4,148,A,Novela%20z.%20-%20ob%u010Dansk%FD%20z%E1kon%EDk%20-%20EU
52824,20,1291762800,61,83,12,7,163,R,Novela%20z%20-%20ob%u010Dansk%FD%20z%E1kon%EDk
52825,20,1291762800,60,88,3,4,155,R,Novela%20z%20-%20ob%u010Dansk%FD%20z%E1kon%EDk
52826,20,1291762800,148,3,3,2,156,A,Novela%20z%20-%20ob%u010Dansk%FD%20z%E1kon%EDk
52827,20,1291762800,150,4,1,1,156,A,Novela%20z%20-%20ob%u010Dansk%FD%20z%E1kon%EDk
52828,20,1291762800,94,58,1,3,156,A,Novela%20z%20-%20ob%u010Dansk%FD%20z%E1kon%EDk
52829,19,1291762800,111,0,42,1,154,A,Novela%20z.%20o%20v%FDkonu%20povol%E1n%ED%20autorizovan%FDch%20architekt%u016F
52830,19,1291762800,89,0,64,1,154,A,Novela%20z.%20o%20v%FDkonu%20povol%E1n%ED%20autorizovan%FDch%20architekt%u016F
52831,137,1291762800,72,5,52,22,151,R,N%E1vrh%20na%20zkr%E1cen%ED%20lh%u016Fty%20pro%20projedn%E1n%ED%20tisku%20115
52832,137,1291762800,101,5,14,10,130,A,N%E1vrh%20na%20zkr%E1cen%ED%20lh%u016Fty%20pro%20projedn%E1n%ED%20tisku%20115
52833,137,1291762800,86,11,22,20,139,A,N%E1vrh%20na%20zkr%E1cen%ED%20lh%u016Fty%20pro%20projedn%E1n%ED%20tisku%20115
52834,21,1291762800,108,1,32,0,141,A,Novela%20z.%20o%20pozemn%EDch%20komunikac%EDch%20-%20EU
52835,22,1291762800,103,0,38,1,142,A,Novela%20z.%20o%20platebn%EDm%20styku%20-%20EU
52836,23,1291762800,106,2,0,1,109,A,Vl.n.z.%20o%20ob%u011Bhu%20bankovek%20a%20minc%ED%20-%20EU
52837,25,1291762800,107,0,7,0,114,A,Novela%20z.%20o%20civiln%EDm%20letectv%ED%20-%20EU
52838,26,1291762800,79,32,19,2,132,A,Novela%20z.%20%DAstava%20%u010Cesk%E9%20republiky
52839,0,1291849200,60,3,21,12,96,A,Po%u0159ad%20sch%u016Fze
52840,0,1291849200,87,3,13,5,108,A,Po%u0159ad%20sch%u016Fze
52841,0,1291849200,65,7,25,14,111,A,Po%u0159ad%20sch%u016Fze
52842,50,1291849200,57,37,7,13,114,R,Ujedn%E1n%ED%20o%20p%u0159ekladu%20pro%20patent%20Evropsk%E9%20unie
52843,50,1291849200,120,1,5,1,127,A,Ujedn%E1n%ED%20o%20p%u0159ekladu%20pro%20patent%20Evropsk%E9%20unie
52844,50,1291849200,55,66,9,2,132,R,Ujedn%E1n%ED%20o%20p%u0159ekladu%20pro%20patent%20Evropsk%E9%20unie
52845,50,1291849200,54,71,6,4,135,R,Ujedn%E1n%ED%20o%20p%u0159ekladu%20pro%20patent%20Evropsk%E9%20unie
52846,50,1291849200,80,11,28,18,137,A,Ujedn%E1n%ED%20o%20p%u0159ekladu%20pro%20patent%20Evropsk%E9%20unie
52847,50,1291849200,80,11,29,16,136,A,Ujedn%E1n%ED%20o%20p%u0159ekladu%20pro%20patent%20Evropsk%E9%20unie
52848,50,1291849200,82,13,25,16,136,A,Ujedn%E1n%ED%20o%20p%u0159ekladu%20pro%20patent%20Evropsk%E9%20unie
52849,50,1291849200,82,33,11,11,137,A,Ujedn%E1n%ED%20o%20p%u0159ekladu%20pro%20patent%20Evropsk%E9%20unie
52850,50,1291849200,80,32,11,14,137,A,Ujedn%E1n%ED%20o%20p%u0159ekladu%20pro%20patent%20Evropsk%E9%20unie
52851,51,1291849200,110,0,2,4,116,A,P%u0159ezkum%20rozpo%u010Dtu%20EU
52852,51,1291849200,101,2,5,11,119,A,P%u0159ezkum%20rozpo%u010Dtu%20EU
52853,51,1291849200,79,4,21,16,120,A,P%u0159ezkum%20rozpo%u010Dtu%20EU
52854,51,1291849200,82,2,24,13,121,A,P%u0159ezkum%20rozpo%u010Dtu%20EU
52855,51,1291849200,105,1,6,9,121,A,P%u0159ezkum%20rozpo%u010Dtu%20EU
52856,51,1291849200,77,2,26,16,121,A,P%u0159ezkum%20rozpo%u010Dtu%20EU
52857,0,1291849200,93,8,9,10,120,A,%20
52858,58,1291849200,103,0,3,0,106,A,Sml.%20mezi%20%u010CR%20a%20vl.%20%u010C%EDnsk%E9%20lid.%20rep.%20o%20zamezen%ED%20dvoj.%20zdan%u011Bn%ED
52859,59,1291849200,101,0,4,1,106,A,Doh.%20mezi%20%u010CR%20a%20Kr%E1lovstv%EDm%20Saudsk%E9%20Ar%E1bie%20o%20ochran%u011B%20investic
52860,52,1291849200,96,0,5,5,106,A,Protokol%20mezi%20%u010CR%20a%20Indickou%20rep.%20o%20podpo%u0159e%20a%20ochr.%20investic
52861,53,1291849200,103,0,3,1,107,A,Smlouva%20mezi%20%u010CR%20a%20Austr%E1li%ED%20o%20soci%E1ln%EDm%20zabezpe%u010Den%ED
52862,54,1291849200,101,0,3,3,107,A,Doh.%20mezi%20%u010CR%20a%20vl%E1dou%20%u010Cern%E9%20Hory%20o%20podpo%u0159e%20a%20ochr.%20investic
52863,55,1291849200,103,0,4,1,108,A,Prot.%20mezi%20%u010CR%20a%20Libanonskou%20rep.%20o%20podpo%u0159e%20a%20ochr.%20investic
52864,56,1291849200,105,0,3,0,108,A,Sml.%20mezi%20%u010CR%20a%20Rep.%20Srbsko%20o%20podpo%u0159e%20a%20ochr.%20investic
52865,57,1291849200,104,0,4,0,108,A,Protokol%20mezi%20%u010CR%20a%20Rep.%20Srbsko%20o%20zamezen%ED%20dvoj%EDmu%20zdan%u011Bn%ED
52866,60,1291849200,105,0,3,0,108,A,Prot.%20mezi%20%u010CR%20a%20Uzbeckou%20rep.%20o%20podpo%u0159e%20a%20ochran%u011B%20investic
52867,61,1291849200,103,0,3,2,108,A,Prot.%20mezi%20%u010CR%20a%20Guatemalskou%20rep.%20o%20podpo%u0159e%20a%20ochr.%20investic
52868,62,1291849200,103,0,4,1,108,A,Doh.mezi%20%u010CR%20a%20Estonskou%20rep.%20o%20zm%u011Bn%u011B%20Dohody%20o%20ochr.%20investic
52869,63,1291849200,104,0,3,1,108,A,Doh.%20mezi%20%u010CR%20a%20Gruzi%ED%20o%20podpo%u0159e%20a%20ochran%u011B%20investic
52870,64,1291849200,100,0,8,0,108,A,%DAmluvy%20MOP%20o%20inspekci%20pr%E1ce%20v%20pr%u016Fm.%20a%20obch.%20a%20v%20zem%u011Bd%u011Blstv%ED
52871,67,1291849200,98,0,9,1,108,A,Doh.%20mezi%20%u010CR%20a%20vl%E1dou%20%C1zerb%E1jd%u017E%E1nsk%E9%20rep.%20o%20leteck%E9%20doprav%u011B
52872,68,1291849200,98,0,10,0,108,A,Sml.%20mezi%20%u010CR%20a%20SR%20o%20%FAdr%u017Eb%u011B%20a%20oprav%E1ch%20silni%u010Dn%EDch%20objekt%u016F
52873,69,1291849200,96,0,12,0,108,A,Doh.%20mezi%20%u010CR%20a%20vl%E1dou%20Arm%E9nsk%E9%20rep.%20o%20leteck%E9%20doprav%u011B
52874,70,1291849200,98,0,10,0,108,A,N%E1vrh%20na%20p%u0159%EDstup%20%u010CR%20k%20Dodatkov%E9mu%20protokolu%20k%20%DAmluv%u011B%20CMR
52875,71,1291849200,96,0,12,0,108,A,Vl.n.zm%u011Bny%20P%u0159%EDlohy%20II%20Mezin%E1rod.%FAml.%20proti%20dopingu%20ve%20sportu
52876,75,1291849200,92,0,13,2,107,A,Statut%20Mezin%E1rodn%ED%20agentury%20pro%20obnoviteln%E9%20zdroje%20energie
52877,76,1291849200,96,0,11,1,108,A,Doh.%20mezi%20%u010CR%20a%20Marock%FDm%20kr%E1l.%20o%20podpo%u0159e%20a%20ochran%u011B%20investic
52878,77,1291849200,96,0,12,0,108,A,Sml.%20o%20soci%E1ln%EDm%20zabezpe%u010Den%ED%20mezi%20%u010CR%20a%20Indickou%20republikou
52879,78,1291849200,98,0,10,0,108,A,Sml.%20mezi%20%u010CR%20a%20Syrskou%20arabskou%20rep.%20o%20soci%E1ln%EDm%20zabezpe%u010Den%ED
52880,79,1291849200,93,1,13,1,108,A,%DAmluva%20o%20centralizovan%E9m%20celn%EDm%20%u0159%EDzen%ED
52881,80,1291849200,91,0,13,0,104,A,Sml.%20mezi%20%u010CR%20a%20%u0160pan%u011Blsk%FDm%20kr%E1l.%20o%20ochran%u011B%20utaj.%20informac%ED
52882,80,1291849200,62,17,19,5,103,A,Sml.%20mezi%20%u010CR%20a%20%u0160pan%u011Blsk%FDm%20kr%E1l.%20o%20ochran%u011B%20utaj.%20informac%ED
52883,81,1291849200,81,3,15,0,99,A,Sml.%20mezi%20%u010CR%20a%20vl.%20Chorvatsk%E9%20rep.%20o%20ochran%u011B%20utaj.%20informac%ED
52884,81,1291849200,52,19,21,8,100,A,Sml.%20mezi%20%u010CR%20a%20vl.%20Chorvatsk%E9%20rep.%20o%20ochran%u011B%20utaj.%20informac%ED
52885,82,1291849200,85,1,15,0,101,A,Sml.mezi%20%u010CR%20a%20Radou%20ministr%u016F%20Alb%E1n.rep.%20o%20ochr.utaj.inform.
52886,82,1291849200,52,18,24,7,101,A,Sml.mezi%20%u010CR%20a%20Radou%20ministr%u016F%20Alb%E1n.rep.%20o%20ochr.utaj.inform.
52887,84,1291849200,88,0,14,0,102,A,Dohoda%20o%20p%u0159evozu%20t%u011Bl%20zem%u0159el%FDch
52888,85,1291849200,88,0,14,0,102,A,Prot.%20mezi%20%u010CR%20a%20Alb%E1nskou%20rep.%20o%20podpo%u0159e%20a%20ochran%u011B%20investic
52889,86,1291849200,86,0,16,0,102,A,Prot.mezi%20%u010CR%20a%20vl.%20B%u011Blorusk%E9%20rep.%20o%20zamezen%ED%20dvoj%EDho%20zdan%u011Bn%ED
52890,87,1291849200,82,0,20,0,102,A,N%E1vrh%20na%20p%u0159%EDstup%20k%20prohl%E1%u0161en%ED%20o%20vyu%u017E%EDv%E1n%ED%20nosn%FDch%20raket
52891,87,1291849200,88,0,14,1,103,A,N%E1vrh%20na%20p%u0159%EDstup%20k%20prohl%E1%u0161en%ED%20o%20vyu%u017E%EDv%E1n%ED%20nosn%FDch%20raket
52892,88,1291849200,87,0,16,0,103,A,Vl.n.%20na%20souhlas%20s%20ratifikac%ED%20Akt%20Sv%u011Btov%E9%20po%u0161tovn%ED%20unie
52893,89,1291849200,85,0,18,0,103,A,Doh.%20mezi%20%u010CR%20a%20vl.%20Austr%E1lie%20o%20leteck%FDch%20slu%u017Eb%E1ch
52894,89,1291849200,85,0,16,0,101,A,Doh.%20mezi%20%u010CR%20a%20vl.%20Austr%E1lie%20o%20leteck%FDch%20slu%u017Eb%E1ch
52895,0,1291935600,78,26,25,8,137,A,Po%u0159ad%20sch%u016Fze
52896,0,1291935600,132,0,9,1,142,A,Po%u0159ad%20sch%u016Fze
52897,0,1291935600,95,4,28,15,142,A,Po%u0159ad%20sch%u016Fze
52898,0,1291935600,136,0,9,0,145,A,Po%u0159ad%20sch%u016Fze
52899,96,1291935600,91,0,62,0,153,A,Novela%20z.%20o%20krmivech%20-%20EU
52900,96,1291935600,148,0,6,1,155,A,Novela%20z.%20o%20krmivech%20-%20EU
52901,97,1291935600,149,0,7,0,156,A,Novela%20z.%20o%20%u0161lecht%u011Bn%ED%2C%20plemenitb%u011B%20a%20evidenci%20hosp.%20zv%ED%u0159at%20-%20EU
52902,103,1291935600,157,0,6,2,165,A,Novela%20z.%20o%20platu%20p%u0159edstavitel%u016F%20st%E1tn%ED%20moci
52903,103,1291935600,117,7,17,24,165,A,Novela%20z.%20o%20platu%20p%u0159edstavitel%u016F%20st%E1tn%ED%20moci
52904,103,1291935600,157,1,4,1,163,A,Novela%20z.%20o%20platu%20p%u0159edstavitel%u016F%20st%E1tn%ED%20moci
52905,103,1291935600,32,64,20,48,164,R,Novela%20z.%20o%20platu%20p%u0159edstavitel%u016F%20st%E1tn%ED%20moci
52906,103,1291935600,65,71,14,14,164,R,Novela%20z.%20o%20platu%20p%u0159edstavitel%u016F%20st%E1tn%ED%20moci
52907,103,1291935600,66,84,5,10,165,R,Novela%20z.%20o%20platu%20p%u0159edstavitel%u016F%20st%E1tn%ED%20moci
52908,103,1291935600,133,2,7,21,163,A,Novela%20z.%20o%20platu%20p%u0159edstavitel%u016F%20st%E1tn%ED%20moci
52909,103,1291935600,42,64,28,30,164,R,Novela%20z.%20o%20platu%20p%u0159edstavitel%u016F%20st%E1tn%ED%20moci
52910,103,1291935600,120,3,8,34,165,A,Novela%20z.%20o%20platu%20p%u0159edstavitel%u016F%20st%E1tn%ED%20moci
52911,103,1291935600,147,1,11,3,162,A,Novela%20z.%20o%20platu%20p%u0159edstavitel%u016F%20st%E1tn%ED%20moci
52912,16,1291935600,95,1,67,0,163,A,Novela%20z.%20o%20ochran%u011B%20ve%u0159ejn%E9ho%20zdrav%ED%20-%20EU
52913,112,1291935600,94,0,65,2,161,A,1.%20dopln%u011Bk%20pl%E1nu%20voj.cvi%u010Den%ED%20A%u010CR%20se%20zahrani%u010Dn%EDmi%20partnery
52914,113,1291935600,82,12,60,9,163,A,Inf.%20o%20nasazen%ED%20sil%20MO%20v%20zahrani%u010Dn%EDch%20operac%EDch%20v%20roce%202009
52915,114,1291935600,91,0,67,5,163,A,Inf.o%20vojensk%FDch%20cvi%u010Den%EDch%20A%u010CR%20za%20obdob%ED%20leden%20-%20%u010Derven%202010
52916,115,1291935600,95,11,56,2,164,A,Inf.%20o%20p%u0159eletech%20a%20pr%u016Fjezdech%20ozbroj.%20sil%20v%201.%20pololet%ED%202010
52917,116,1291935600,98,0,60,4,162,A,2.dopln%u011Bk%20pl%E1nu%20voj.cvi%u010Den%ED%20A%u010CR%20se%20zahr.partnery%20v%20roce%202010
52918,27,1291935600,95,64,0,0,159,A,N%E1vrh%20%FAstavn%EDho%20z%E1kona%20o%20celost%E1tn%EDm%20referendu
52919,28,1291935600,89,57,2,0,148,A,N.z.%20o%20zru%u0161en%ED%20listinn%FDch%20akci%ED%20na%20majitele
52920,0,1292281200,125,7,9,12,153,A,Po%u0159ad%20sch%u016Fze
52921,0,1292281200,159,2,5,4,170,A,Po%u0159ad%20sch%u016Fze
52922,0,1292281200,149,8,7,6,170,A,Po%u0159ad%20sch%u016Fze
52923,0,1292281200,42,13,108,6,169,R,Po%u0159ad%20sch%u016Fze
52924,0,1292281200,68,72,16,13,169,R,Po%u0159ad%20sch%u016Fze
52925,0,1292281200,100,13,29,28,170,A,Po%u0159ad%20sch%u016Fze
52926,0,1292281200,98,18,35,19,170,A,Po%u0159ad%20sch%u016Fze
52927,0,1292281200,97,11,37,26,171,A,Po%u0159ad%20sch%u016Fze
52928,0,1292281200,101,15,30,25,171,A,Po%u0159ad%20sch%u016Fze
52929,140,1292281200,105,6,53,5,169,A,Novela%20z.%20-%20ob%u010Dansk%FD%20z%E1kon%EDk%20-%20EU
52930,142,1292281200,112,3,48,5,168,A,Novela%20z.%20o%20technick%FDch%20po%u017Eadavc%EDch%20na%20v%FDrobky%20-%20EU
52931,39,1292281200,142,0,7,2,151,A,Novela%20z.%20o%20odpadech
52932,39,1292281200,151,0,2,1,154,A,Novela%20z.%20o%20odpadech
52933,11,1292281200,142,1,20,2,165,A,Novela%20z.%20o%20podm.%20prov.%20vozidel%20na%20pozem.%20komunikac%EDch
52934,41,1292281200,79,52,4,0,135,A,Novela%20z.%20o%20podm.%20prov.%20vozidel%20na%20pozem.%20komunikac%EDch
52935,44,1292281200,106,0,35,3,144,A,Novela%20z.%20o%20V%DASC
52936,45,1292281200,79,53,16,3,151,A,Novela%20z.%20-%20soudn%ED%20%u0159%E1d%20spr%E1vn%ED
52937,46,1292281200,87,66,1,0,154,A,Novela%20z.%20o%20poji%u0161%u0165ovnictv%ED
52938,13,1292281200,37,66,28,27,158,R,Novela%20z.%20o%20platu%20p%u0159edstavitel%u016F%20st%E1tn%ED%20moci
52939,13,1292281200,0,3,154,0,157,R,Novela%20z.%20o%20platu%20p%u0159edstavitel%u016F%20st%E1tn%ED%20moci
52940,13,1292281200,83,44,4,13,144,A,Novela%20z.%20o%20platu%20p%u0159edstavitel%u016F%20st%E1tn%ED%20moci
52941,0,1292367600,100,13,51,8,172,A,Po%u0159ad%20sch%u016Fze
52942,0,1292367600,85,22,51,14,172,R,Po%u0159ad%20sch%u016Fze
52943,0,1292367600,134,14,14,7,169,A,Po%u0159ad%20sch%u016Fze
52944,0,1292367600,97,30,27,16,170,A,Po%u0159ad%20sch%u016Fze
52945,91,1292367600,160,2,10,2,174,A,Vl.%20n.%20z.%20o%20st%E1tn%EDm%20rozpo%u010Dtu%20%u010CR%20na%20rok%202011
52946,91,1292367600,102,13,31,23,169,A,Vl.%20n.%20z.%20o%20st%E1tn%EDm%20rozpo%u010Dtu%20%u010CR%20na%20rok%202011
52947,91,1292367600,74,106,5,0,185,R,Vl.%20n.%20z.%20o%20st%E1tn%EDm%20rozpo%u010Dtu%20%u010CR%20na%20rok%202011
52948,91,1292367600,181,1,3,2,187,A,Vl.%20n.%20z.%20o%20st%E1tn%EDm%20rozpo%u010Dtu%20%u010CR%20na%20rok%202011
52949,91,1292367600,183,0,3,1,187,A,Vl.%20n.%20z.%20o%20st%E1tn%EDm%20rozpo%u010Dtu%20%u010CR%20na%20rok%202011
52950,91,1292367600,75,110,2,0,187,R,Vl.%20n.%20z.%20o%20st%E1tn%EDm%20rozpo%u010Dtu%20%u010CR%20na%20rok%202011
52951,91,1292367600,76,107,4,0,187,R,Vl.%20n.%20z.%20o%20st%E1tn%EDm%20rozpo%u010Dtu%20%u010CR%20na%20rok%202011
52952,91,1292367600,76,110,1,0,187,R,Vl.%20n.%20z.%20o%20st%E1tn%EDm%20rozpo%u010Dtu%20%u010CR%20na%20rok%202011
52953,91,1292367600,75,105,4,3,187,R,Vl.%20n.%20z.%20o%20st%E1tn%EDm%20rozpo%u010Dtu%20%u010CR%20na%20rok%202011
52954,91,1292367600,75,111,1,0,187,R,Vl.%20n.%20z.%20o%20st%E1tn%EDm%20rozpo%u010Dtu%20%u010CR%20na%20rok%202011
52955,91,1292367600,76,110,0,1,187,R,Vl.%20n.%20z.%20o%20st%E1tn%EDm%20rozpo%u010Dtu%20%u010CR%20na%20rok%202011
52956,91,1292367600,74,109,3,1,187,R,Vl.%20n.%20z.%20o%20st%E1tn%EDm%20rozpo%u010Dtu%20%u010CR%20na%20rok%202011
52957,91,1292367600,76,109,2,0,187,R,Vl.%20n.%20z.%20o%20st%E1tn%EDm%20rozpo%u010Dtu%20%u010CR%20na%20rok%202011
52958,91,1292367600,75,110,2,0,187,R,Vl.%20n.%20z.%20o%20st%E1tn%EDm%20rozpo%u010Dtu%20%u010CR%20na%20rok%202011
52959,91,1292367600,75,110,2,0,187,R,Vl.%20n.%20z.%20o%20st%E1tn%EDm%20rozpo%u010Dtu%20%u010CR%20na%20rok%202011
52960,91,1292367600,76,110,1,0,187,R,Vl.%20n.%20z.%20o%20st%E1tn%EDm%20rozpo%u010Dtu%20%u010CR%20na%20rok%202011
52961,91,1292367600,76,110,1,0,187,R,Vl.%20n.%20z.%20o%20st%E1tn%EDm%20rozpo%u010Dtu%20%u010CR%20na%20rok%202011
52962,91,1292367600,75,110,1,1,187,R,Vl.%20n.%20z.%20o%20st%E1tn%EDm%20rozpo%u010Dtu%20%u010CR%20na%20rok%202011
52963,91,1292367600,173,9,0,5,187,A,Vl.%20n.%20z.%20o%20st%E1tn%EDm%20rozpo%u010Dtu%20%u010CR%20na%20rok%202011
52964,91,1292367600,76,110,1,0,187,R,Vl.%20n.%20z.%20o%20st%E1tn%EDm%20rozpo%u010Dtu%20%u010CR%20na%20rok%202011
52965,91,1292367600,74,108,1,4,187,R,Vl.%20n.%20z.%20o%20st%E1tn%EDm%20rozpo%u010Dtu%20%u010CR%20na%20rok%202011
52966,91,1292367600,73,111,2,1,187,R,Vl.%20n.%20z.%20o%20st%E1tn%EDm%20rozpo%u010Dtu%20%u010CR%20na%20rok%202011
52967,91,1292367600,75,111,1,0,187,R,Vl.%20n.%20z.%20o%20st%E1tn%EDm%20rozpo%u010Dtu%20%u010CR%20na%20rok%202011
52968,91,1292367600,76,110,1,0,187,R,Vl.%20n.%20z.%20o%20st%E1tn%EDm%20rozpo%u010Dtu%20%u010CR%20na%20rok%202011
52969,91,1292367600,76,110,1,0,187,R,Vl.%20n.%20z.%20o%20st%E1tn%EDm%20rozpo%u010Dtu%20%u010CR%20na%20rok%202011
52970,91,1292367600,75,106,6,0,187,R,Vl.%20n.%20z.%20o%20st%E1tn%EDm%20rozpo%u010Dtu%20%u010CR%20na%20rok%202011
52971,91,1292367600,170,4,13,0,187,A,Vl.%20n.%20z.%20o%20st%E1tn%EDm%20rozpo%u010Dtu%20%u010CR%20na%20rok%202011
52972,91,1292367600,74,110,3,0,187,R,Vl.%20n.%20z.%20o%20st%E1tn%EDm%20rozpo%u010Dtu%20%u010CR%20na%20rok%202011
52973,91,1292367600,112,75,0,0,187,A,Vl.%20n.%20z.%20o%20st%E1tn%EDm%20rozpo%u010Dtu%20%u010CR%20na%20rok%202011
52974,91,1292367600,110,15,33,29,187,A,Vl.%20n.%20z.%20o%20st%E1tn%EDm%20rozpo%u010Dtu%20%u010CR%20na%20rok%202011
52975,91,1292367600,146,9,25,7,187,A,Vl.%20n.%20z.%20o%20st%E1tn%EDm%20rozpo%u010Dtu%20%u010CR%20na%20rok%202011
52976,91,1292367600,76,35,32,43,186,R,Vl.%20n.%20z.%20o%20st%E1tn%EDm%20rozpo%u010Dtu%20%u010CR%20na%20rok%202011
52977,91,1292367600,78,104,1,4,187,R,Vl.%20n.%20z.%20o%20st%E1tn%EDm%20rozpo%u010Dtu%20%u010CR%20na%20rok%202011
52978,92,1292367600,95,51,1,2,149,A,St%u0159edn%u011Bdob%E9%20v%FDdajov%E9%20r%E1mce%20na%20l%E9ta%202012%20a%202013
52979,93,1292367600,34,69,9,4,116,R,N%E1vrh%20rozpo%u010Dtu%20St%E1tn%EDho%20fondu%20rozvoje%20bydlen%ED%20na%20rok%202011
52980,93,1292367600,95,22,1,4,122,A,N%E1vrh%20rozpo%u010Dtu%20St%E1tn%EDho%20fondu%20rozvoje%20bydlen%ED%20na%20rok%202011
52981,94,1292367600,84,32,15,15,146,A,Rozpo%u010Det%20SFDI%20na%20rok%202011
52982,94,1292367600,115,4,12,15,146,A,Rozpo%u010Det%20SFDI%20na%20rok%202011
52983,95,1292367600,94,2,33,15,144,A,Dota%u010Dn%ED%20programy%20zem%u011Bd%u011Blstv%ED%20pro%20rok%202011
52984,144,1292367600,85,2,37,21,145,A,N%E1vrh%20rozpo%u010Dtu%20SZIF%20na%20rok%202011
52985,135,1292454000,30,38,24,4,96,R,Odpov%u011Bdi%20%u010Dlen%u016F%20vl%E1dy%20na%20p%EDsemn%E9%20interpelace
52986,135,1292454000,35,37,3,0,75,R,Odpov%u011Bdi%20%u010Dlen%u016F%20vl%E1dy%20na%20p%EDsemn%E9%20interpelace
52987,135,1292454000,34,40,2,3,79,R,Odpov%u011Bdi%20%u010Dlen%u016F%20vl%E1dy%20na%20p%EDsemn%E9%20interpelace
52988,135,1292454000,36,43,1,1,81,R,Odpov%u011Bdi%20%u010Dlen%u016F%20vl%E1dy%20na%20p%EDsemn%E9%20interpelace
52989,135,1292454000,0,0,2,0,2,R,Odpov%u011Bdi%20%u010Dlen%u016F%20vl%E1dy%20na%20p%EDsemn%E9%20interpelace
52990,135,1292454000,84,1,1,0,86,A,Odpov%u011Bdi%20%u010Dlen%u016F%20vl%E1dy%20na%20p%EDsemn%E9%20interpelace
52991,135,1292454000,38,47,1,0,86,R,Odpov%u011Bdi%20%u010Dlen%u016F%20vl%E1dy%20na%20p%EDsemn%E9%20interpelace
52992,135,1292454000,37,41,3,1,82,R,Odpov%u011Bdi%20%u010Dlen%u016F%20vl%E1dy%20na%20p%EDsemn%E9%20interpelace
52993,65,1292454000,92,1,23,1,117,A,Doh.%20mezi%20%u010CR%20a%20vl%E1d.Bulh.rep.o%20spolup.%20proti%20trestn%E9%20%u010Din.
52994,65,1292454000,98,0,4,2,104,A,Doh.%20mezi%20%u010CR%20a%20vl%E1d.Bulh.rep.o%20spolup.%20proti%20trestn%E9%20%u010Din.
52995,65,1292454000,103,0,2,0,105,A,Doh.%20mezi%20%u010CR%20a%20vl%E1d.Bulh.rep.o%20spolup.%20proti%20trestn%E9%20%u010Din.
52996,66,1292454000,96,0,14,0,110,A,Sml.%20mezi%20%u010CR%20a%20%u0160v%FDcarskou%20konfederac%ED%20o%20p%u0159ed%E1v%E1n%ED%20osob
52997,72,1292454000,93,0,19,0,112,A,Sml.%20mezi%20%u010CR%20a%20SR%20o%20spole%u010Dn%FDch%20st%E1tn%EDch%20hranic%EDch
52998,73,1292454000,101,1,17,0,119,A,Doh.mezi%20%u010CR%20a%20Rep.Makedonie%20o%20spolup.%20proti%20trestn%E9%20%u010Dinnosti
52999,74,1292454000,98,0,22,0,120,A,Sml.%20mezi%20%u010CR%20a%20Arm%E9nskou%20rep.%20o%20p%u0159ed%E1v%E1n%ED%20a%20p%u0159eb%EDr%E1n%ED%20osob
53000,131,1292454000,62,26,15,18,121,A,V%FDro%u010Dn%ED%20zpr%E1vy%20a%20z%E1v%u011Brky%20zdravotn%EDch%20poji%u0161%u0165oven%20za%20rok%202009
53001,120,1292454000,116,0,16,1,133,A,Zpr%E1va%20o%20situaci%20v%20oblasti%20migrace%20na%20%FAzem%ED%20%u010CR%20za%20rok%202009
53002,105,1292454000,113,0,24,0,137,A,N%E1vrh%20na%20volbu%20%u010Dlena%20Nejvy%u0161%u0161%EDho%20kontroln%EDho%20%FA%u0159adu
53003,106,1292454000,118,0,19,0,137,A,N%E1vrh%20na%20volbu%20%u010Dlena%20Rady%20%u010Cesk%E9%20televize
53004,107,1292454000,119,0,20,0,139,A,N%E1vrh%20na%20volbu%20%u010Dlen%u016F%20Rady%20%u010Cesk%E9ho%20rozhlasu
53005,108,1292454000,119,0,20,0,139,A,N%E1vrh%20na%20volbu%20%u010Dlena%20Rady%20%u010Cesk%E9%20tiskov%E9%20kancel%E1%u0159e
53006,110,1292454000,121,0,18,0,139,A,N%E1vrh%20na%20volbu%20%u010Dlena%20DR%20PF%20%u010CR
53007,138,1292454000,121,0,20,0,141,A,N%E1vrh%20na%20zm%u011Bny%20ve%20slo%u017Een%ED%20org%E1n%u016F%20Poslaneck%E9%20sn%u011Bmovny
53008,138,1292454000,121,0,20,0,141,A,N%E1vrh%20na%20zm%u011Bny%20ve%20slo%u017Een%ED%20org%E1n%u016F%20Poslaneck%E9%20sn%u011Bmovny
53009,0,1292540400,81,27,19,11,138,A,Po%u0159ad%20sch%u016Fze
53010,0,1292540400,127,1,10,6,144,A,Po%u0159ad%20sch%u016Fze
53011,102,1292540400,59,83,7,1,150,R,N.z.%20o%20%DA%u0159adu%20pr%E1ce%20%u010Cesk%E9%20republiky
53012,102,1292540400,125,10,6,9,150,A,N.z.%20o%20%DA%u0159adu%20pr%E1ce%20%u010Cesk%E9%20republiky
53013,102,1292540400,55,86,7,2,150,R,N.z.%20o%20%DA%u0159adu%20pr%E1ce%20%u010Cesk%E9%20republiky
53014,102,1292540400,86,57,6,3,152,A,N.z.%20o%20%DA%u0159adu%20pr%E1ce%20%u010Cesk%E9%20republiky
53015,148,1292540400,102,3,39,7,151,A,Novela%20z.%20-%20ob%u010Dansk%FD%20z%E1kon%EDk%20-%20EU
53016,148,1292540400,108,1,34,8,151,A,Novela%20z.%20-%20ob%u010Dansk%FD%20z%E1kon%EDk%20-%20EU
53017,143,1292540400,106,0,35,8,149,A,Novela%20z.%20o%20technick%FDch%20po%u017Eadavc%EDch%20na%20v%FDrobky%20-%20EU
53018,143,1292540400,120,5,20,3,148,A,Novela%20z.%20o%20technick%FDch%20po%u017Eadavc%EDch%20na%20v%FDrobky%20-%20EU
53019,146,1292540400,81,30,34,4,149,A,Vl.n.z.%20o%20st%E1tn%EDm%20dluhopisov%E9m%20programu
53020,98,1292540400,128,1,21,1,151,A,Novela%20z.%20v%20souvislosti%20se%20stanoven%EDm%20kapit%E1lov%FDch%20po%u017Eadavk%u016F%20-%20EU
53021,98,1292540400,128,0,21,2,151,A,Novela%20z.%20v%20souvislosti%20se%20stanoven%EDm%20kapit%E1lov%FDch%20po%u017Eadavk%u016F%20-%20EU
53022,98,1292540400,132,1,17,1,151,A,Novela%20z.%20v%20souvislosti%20se%20stanoven%EDm%20kapit%E1lov%FDch%20po%u017Eadavk%u016F%20-%20EU
53023,99,1292540400,141,1,9,1,152,A,Novela%20z.%20o%20dani%20z%20p%u0159idan%E9%20hodnoty%20-%20EU
53024,99,1292540400,145,0,5,1,151,A,Novela%20z.%20o%20dani%20z%20p%u0159idan%E9%20hodnoty%20-%20EU
53025,99,1292540400,144,0,5,2,151,A,Novela%20z.%20o%20dani%20z%20p%u0159idan%E9%20hodnoty%20-%20EU
53026,99,1292540400,144,0,5,2,151,A,Novela%20z.%20o%20dani%20z%20p%u0159idan%E9%20hodnoty%20-%20EU
53027,99,1292540400,144,0,6,1,151,A,Novela%20z.%20o%20dani%20z%20p%u0159idan%E9%20hodnoty%20-%20EU
53028,99,1292540400,137,2,8,4,151,A,Novela%20z.%20o%20dani%20z%20p%u0159idan%E9%20hodnoty%20-%20EU
53029,99,1292540400,143,0,6,2,151,A,Novela%20z.%20o%20dani%20z%20p%u0159idan%E9%20hodnoty%20-%20EU
53030,99,1292540400,143,0,7,1,151,A,Novela%20z.%20o%20dani%20z%20p%u0159idan%E9%20hodnoty%20-%20EU
53031,99,1292540400,136,4,7,4,151,A,Novela%20z.%20o%20dani%20z%20p%u0159idan%E9%20hodnoty%20-%20EU
53032,99,1292540400,145,1,3,2,151,A,Novela%20z.%20o%20dani%20z%20p%u0159idan%E9%20hodnoty%20-%20EU
53033,99,1292540400,140,0,9,2,151,A,Novela%20z.%20o%20dani%20z%20p%u0159idan%E9%20hodnoty%20-%20EU
53034,99,1292540400,143,2,5,1,151,A,Novela%20z.%20o%20dani%20z%20p%u0159idan%E9%20hodnoty%20-%20EU
53035,99,1292540400,145,0,4,2,151,A,Novela%20z.%20o%20dani%20z%20p%u0159idan%E9%20hodnoty%20-%20EU
53036,99,1292540400,114,4,9,23,150,A,Novela%20z.%20o%20dani%20z%20p%u0159idan%E9%20hodnoty%20-%20EU
53037,100,1292540400,52,72,11,4,139,R,Novela%20z.%20%DAstava%20%u010Cesk%E9%20republiky
53038,100,1292540400,55,29,40,19,143,R,Novela%20z.%20%DAstava%20%u010Cesk%E9%20republiky
53039,100,1292540400,89,3,24,8,124,R,Novela%20z.%20%DAstava%20%u010Cesk%E9%20republiky
53040,0,1292540400,89,3,21,6,119,A,%20
53041,0,1292886000,135,0,14,0,149,A,%20
53042,0,1292886000,65,112,2,6,185,R,Po%u0159ad%20sch%u016Fze
53043,0,1292886000,68,104,6,7,185,R,Po%u0159ad%20sch%u016Fze
53044,0,1292886000,165,6,10,4,185,A,Po%u0159ad%20sch%u016Fze
53045,0,1292886000,163,1,13,6,183,A,%20
53046,1,1292886000,28,138,10,13,189,R,Novela%20z.%20o%20krizov%E9m%20%u0159%EDzen%ED%20-%20EU
53047,1,1292886000,155,0,28,7,190,A,Novela%20z.%20o%20krizov%E9m%20%u0159%EDzen%ED%20-%20EU
53048,2,1292886000,54,97,28,13,192,R,Novela%20z.%20o%20pobytu%20cizinc%u016F%20na%20%FAzem%ED%20%u010CR
53049,2,1292886000,109,9,33,41,192,A,Novela%20z.%20o%20pobytu%20cizinc%u016F%20na%20%FAzem%ED%20%u010CR
53050,0,1292886000,106,1,17,0,124,A,%20
53051,0,1292886000,120,3,19,3,145,A,Po%u0159ad%20sch%u016Fze
53052,0,1292886000,81,100,7,1,189,R,Po%u0159ad%20sch%u016Fze
53053,0,1292886000,91,1,19,0,111,A,%20
53054,0,1292886000,128,2,12,0,142,A,%20
53055,1,1292886000,0,0,182,0,182,R,N%E1vrh%20na%20vysloven%ED%20ned%u016Fv%u011Bry%20vl%E1d%u011B%20%u010Cesk%E9%20republiky
53056,0,1296514800,118,1,22,0,141,A,%20
53057,0,1296514800,136,12,19,24,191,A,Po%u0159ad%20sch%u016Fze
53058,0,1296514800,77,101,10,3,191,R,Po%u0159ad%20sch%u016Fze
53059,0,1296514800,76,95,10,9,190,R,Po%u0159ad%20sch%u016Fze
53060,0,1296514800,77,104,7,2,190,R,Po%u0159ad%20sch%u016Fze
53061,0,1296514800,114,40,28,9,191,A,Po%u0159ad%20sch%u016Fze
53062,0,1296514800,111,40,28,12,191,A,Po%u0159ad%20sch%u016Fze
53063,0,1296514800,110,44,29,8,191,A,Po%u0159ad%20sch%u016Fze
53064,0,1296514800,131,12,37,11,191,A,Po%u0159ad%20sch%u016Fze
53065,0,1296514800,136,11,31,13,191,A,Po%u0159ad%20sch%u016Fze
53066,0,1296514800,49,18,34,8,109,R,Po%u0159ad%20sch%u016Fze
53067,0,1296514800,103,46,0,27,176,R,Po%u0159ad%20sch%u016Fze
53068,0,1296514800,115,40,0,24,179,R,Po%u0159ad%20sch%u016Fze
53069,0,1296601200,0,0,0,0,0,R,Po%u0159ad%20sch%u016Fze
53070,0,1296601200,0,0,0,0,0,R,Po%u0159ad%20sch%u016Fze
53071,0,1296601200,0,0,0,0,0,R,Po%u0159ad%20sch%u016Fze
53072,0,1296601200,0,0,1,0,1,R,Po%u0159ad%20sch%u016Fze
53073,0,1296601200,0,0,1,0,1,R,Po%u0159ad%20sch%u016Fze
53074,0,1296601200,0,0,1,0,1,R,Po%u0159ad%20sch%u016Fze
53075,0,1296601200,0,0,1,0,1,R,Po%u0159ad%20sch%u016Fze
53076,0,1296601200,0,0,1,0,1,R,Po%u0159ad%20sch%u016Fze
53077,0,1296601200,0,0,1,0,1,R,Po%u0159ad%20sch%u016Fze
53078,0,1296601200,0,0,1,0,1,R,Po%u0159ad%20sch%u016Fze
53079,0,1296601200,0,0,1,0,1,R,Po%u0159ad%20sch%u016Fze
53080,0,1296601200,0,0,1,0,1,R,Po%u0159ad%20sch%u016Fze
53081,0,1296601200,0,0,1,0,1,R,Po%u0159ad%20sch%u016Fze
53082,0,1296601200,0,0,1,0,1,R,Po%u0159ad%20sch%u016Fze
53083,0,1296601200,0,0,1,0,1,R,Po%u0159ad%20sch%u016Fze
53084,0,1296601200,0,0,1,0,1,R,Po%u0159ad%20sch%u016Fze
53085,0,1296601200,1,0,1,0,2,R,Po%u0159ad%20sch%u016Fze
53086,0,1296601200,0,1,2,0,3,R,Po%u0159ad%20sch%u016Fze
53087,0,1296601200,110,1,30,2,143,A,Po%u0159ad%20sch%u016Fze
53088,0,1296601200,86,16,21,24,147,A,Po%u0159ad%20sch%u016Fze
53089,0,1296601200,143,1,8,0,152,A,Po%u0159ad%20sch%u016Fze
53090,86,1296601200,118,5,26,9,158,A,Zpr%E1va%20o%20v%FDkonu%20dohledu%20nad%20finan%u010Dn%EDm%20trhem%20v%20roce%202009
53091,87,1296601200,136,2,21,2,161,A,Zpr%E1va%20o%20finan%u010Dn%ED%20stabilit%u011B%202009/2010
53092,89,1296601200,130,2,36,3,171,A,Zpr%E1va%20o%20inflaci%20-%20%u010Dervenec%202010
53093,9,1296601200,116,13,43,2,174,A,Novela%20z.%20o%20%u010Cesk%E9%20n%E1rodn%ED%20bance%20-%20EU
53094,9,1296601200,142,4,27,1,174,A,Novela%20z.%20o%20%u010Cesk%E9%20n%E1rodn%ED%20bance%20-%20EU
53095,40,1296601200,130,3,43,0,176,A,Novela%20z.%20o%20st%E1tn%EDm%20rozpo%u010Dtu%20%u010CR%20na%20rok%202011
53096,13,1296601200,151,1,26,1,179,A,Vl.n.z.%20o%20st%E1tn%EDm%20dluhopisov%E9m%20programu
53097,13,1296601200,95,28,21,10,154,A,Vl.n.z.%20o%20st%E1tn%EDm%20dluhopisov%E9m%20programu
53098,15,1296601200,158,1,14,0,173,A,Novela%20devizov%E9ho%20z%E1kona%20-%20EU
53099,15,1296601200,145,9,18,1,173,A,Novela%20devizov%E9ho%20z%E1kona%20-%20EU
53100,15,1296601200,90,51,17,15,173,A,Novela%20devizov%E9ho%20z%E1kona%20-%20EU
53101,16,1296601200,126,0,49,0,175,A,Novela%20z.%20o%20nakl%E1d%E1n%ED%20se%20surov%FDmi%20diamanty%20-%20EU
53102,17,1296601200,137,0,40,0,177,A,Novela%20z.%20o%20finan%u010Dn%EDm%20arbitrovi%20-%20EU
53103,18,1296601200,137,1,39,1,178,A,Novela%20z.%20o%20opat%u0159en%EDch%20t%FDkaj%EDc%EDch%20se%20dovozu%20a%20v%FDvozu%20zbo%u017E%ED%20-%20EU
53104,28,1296601200,156,1,25,0,182,A,Novela%20z.%20o%20dani%20z%20nemovitost%ED
53105,14,1296601200,116,1,60,1,178,A,Novela%20z.%20o%20Policii%20%u010CR%20-%20EU
53106,14,1296601200,122,0,57,0,179,A,Novela%20z.%20o%20Policii%20%u010CR%20-%20EU
53107,14,1296601200,119,7,51,3,180,A,Novela%20z.%20o%20Policii%20%u010CR%20-%20EU
53108,66,1296601200,130,0,50,1,181,A,%DAmluva%20o%20kazetov%E9%20munici
53109,34,1296601200,132,0,49,0,181,A,Vl.n.z.%20o%20z%E1kazu%20kazetov%E9%20munice
53110,54,1296601200,97,0,73,10,180,A,Vl.n.%20k%20souhlasu%20s%20ratifikac%ED%20Memoranda%20o%20porozum%u011Bn%ED
53111,100,1296601200,136,0,43,0,179,A,Zpro%u0161t%u011Bn%ED%20ml%u010Denlivosti%20M.%20Krej%u010D%EDka
53112,7,1296601200,126,2,50,0,178,A,Novela%20z.%20o%20l%E9%u010Divech%20-%20EU
53113,7,1296601200,124,1,51,3,179,A,Novela%20z.%20o%20l%E9%u010Divech%20-%20EU
53114,10,1296601200,141,1,32,5,179,A,Novela%20z.%20o%20nel%E9ka%u0159sk%FDch%20zdravotnick%FDch%20povol%E1n%EDch
53115,10,1296601200,151,0,29,0,180,A,Novela%20z.%20o%20nel%E9ka%u0159sk%FDch%20zdravotnick%FDch%20povol%E1n%EDch
53116,11,1296601200,98,46,28,9,181,A,N.z.%20o%20p%u0159echodn%E9m%20sn%ED%u017Een%ED%20cen%20a%20%FAhrad%20l%E9%u010Div
53117,11,1296601200,100,27,40,14,181,A,N.z.%20o%20p%u0159echodn%E9m%20sn%ED%u017Een%ED%20cen%20a%20%FAhrad%20l%E9%u010Div
53118,12,1296601200,121,1,1,0,123,A,Novela%20z.%20o%20o%20integrov.%20registru%20zne%u010Di%u0161%u0165ov%E1n%ED%20%u017Eiv.%20prost%u0159ed%ED
53119,12,1296601200,128,0,1,0,129,A,Novela%20z.%20o%20o%20integrov.%20registru%20zne%u010Di%u0161%u0165ov%E1n%ED%20%u017Eiv.%20prost%u0159ed%ED
53120,100,1296601200,157,0,0,0,157,A,Zpro%u0161t%u011Bn%ED%20ml%u010Denlivosti%20M.%20Krej%u010D%EDka
53121,23,1296601200,95,60,4,1,160,A,Novela%20z.%20o%20spot%u0159ebitelsk%E9m%20%FAv%u011Bru
53122,0,1296687600,94,0,9,0,103,A,%20
53123,101,1296687600,4,1,116,0,121,R,Odpov%u011Bdi%20%u010Dlen%u016F%20vl%E1dy%20na%20p%EDsemn%E9%20interpelace
53124,101,1296687600,55,36,1,5,97,A,Odpov%u011Bdi%20%u010Dlen%u016F%20vl%E1dy%20na%20p%EDsemn%E9%20interpelace
53125,101,1296687600,48,34,0,2,84,A,Odpov%u011Bdi%20%u010Dlen%u016F%20vl%E1dy%20na%20p%EDsemn%E9%20interpelace
53126,50,1296687600,116,2,1,1,120,A,Z%E1v%u011Bry%20p%E1t%E9%20zpr%E1vy%20o%20soudr%u017Enosti
53127,51,1296687600,84,4,26,18,132,A,N%E1vrh%20na%u0159%EDzen%ED%20o%20pos%EDlen%ED%20dohledu%20nad%20stavy%20rozpo%u010Dt%u016F
53128,73,1296774000,153,0,7,1,161,A,Novela%20z.%20o%20provozu%20na%20pozemn%EDch%20komunikac%EDch
53129,73,1296774000,157,0,4,1,162,A,Novela%20z.%20o%20provozu%20na%20pozemn%EDch%20komunikac%EDch
53130,73,1296774000,61,70,16,16,163,R,Novela%20z.%20o%20provozu%20na%20pozemn%EDch%20komunikac%EDch
53131,73,1296774000,143,2,11,8,164,A,Novela%20z.%20o%20provozu%20na%20pozemn%EDch%20komunikac%EDch
53132,73,1296774000,95,45,11,13,164,A,Novela%20z.%20o%20provozu%20na%20pozemn%EDch%20komunikac%EDch
53133,73,1296774000,146,3,12,3,164,A,Novela%20z.%20o%20provozu%20na%20pozemn%EDch%20komunikac%EDch
53134,73,1296774000,90,46,18,10,164,A,Novela%20z.%20o%20provozu%20na%20pozemn%EDch%20komunikac%EDch
53135,73,1296774000,156,0,6,2,164,A,Novela%20z.%20o%20provozu%20na%20pozemn%EDch%20komunikac%EDch
53136,73,1296774000,160,0,4,0,164,A,Novela%20z.%20o%20provozu%20na%20pozemn%EDch%20komunikac%EDch
53137,73,1296774000,136,5,13,9,163,A,Novela%20z.%20o%20provozu%20na%20pozemn%EDch%20komunikac%EDch
53138,73,1296774000,59,95,6,3,163,R,Novela%20z.%20o%20provozu%20na%20pozemn%EDch%20komunikac%EDch
53139,73,1296774000,119,35,6,3,163,A,Novela%20z.%20o%20provozu%20na%20pozemn%EDch%20komunikac%EDch
53140,73,1296774000,61,63,17,22,163,R,Novela%20z.%20o%20provozu%20na%20pozemn%EDch%20komunikac%EDch
53141,73,1296774000,37,74,36,16,163,R,Novela%20z.%20o%20provozu%20na%20pozemn%EDch%20komunikac%EDch
53142,73,1296774000,136,3,5,19,163,A,Novela%20z.%20o%20provozu%20na%20pozemn%EDch%20komunikac%EDch
53143,75,1296774000,162,0,7,0,169,A,Novela%20z.%20o%20spot%u0159ebn%EDch%20dan%EDch%20-%20EU
53144,75,1296774000,32,92,14,31,169,R,Novela%20z.%20o%20spot%u0159ebn%EDch%20dan%EDch%20-%20EU
53145,75,1296774000,157,0,8,4,169,A,Novela%20z.%20o%20spot%u0159ebn%EDch%20dan%EDch%20-%20EU
53146,75,1296774000,19,109,31,10,169,R,Novela%20z.%20o%20spot%u0159ebn%EDch%20dan%EDch%20-%20EU
53147,75,1296774000,156,1,6,6,169,A,Novela%20z.%20o%20spot%u0159ebn%EDch%20dan%EDch%20-%20EU
53148,42,1296774000,118,12,7,8,145,A,Novela%20z.%20-%20%u0161kolsk%FD%20z%E1kon
53149,6,1296774000,77,27,41,4,149,A,Novela%20z%20-%20ob%u010Dansk%FD%20z%E1kon%EDk
53150,8,1296774000,122,0,25,0,147,A,Novela%20z.%20o%20pohonn%FDch%20hmot%E1ch%20-%20EU
53151,8,1296774000,123,1,23,0,147,A,Novela%20z.%20o%20pohonn%FDch%20hmot%E1ch%20-%20EU
53152,0,1297119600,103,24,13,8,148,A,Po%u0159ad%20sch%u016Fze
53153,0,1297119600,138,6,5,4,153,A,Po%u0159ad%20sch%u016Fze
53154,0,1297119600,148,1,4,3,156,A,Po%u0159ad%20sch%u016Fze
53155,0,1297119600,96,24,29,19,168,A,Po%u0159ad%20sch%u016Fze
53156,0,1297119600,126,6,27,9,168,A,Po%u0159ad%20sch%u016Fze
53157,0,1297119600,99,14,37,18,168,A,Po%u0159ad%20sch%u016Fze
53158,0,1297119600,95,18,31,24,168,A,Po%u0159ad%20sch%u016Fze
53159,0,1297119600,96,18,34,20,168,A,Po%u0159ad%20sch%u016Fze
53160,0,1297119600,96,32,29,11,168,A,Po%u0159ad%20sch%u016Fze
53161,0,1297119600,2,1,165,0,168,R,Po%u0159ad%20sch%u016Fze
53162,0,1297119600,122,36,6,4,168,A,Po%u0159ad%20sch%u016Fze
53163,105,1297119600,91,25,35,16,167,A,Vl.n.z.%20o%20st%E1tn%EDm%20dluhopisov%E9m%20programu
53164,103,1297119600,98,22,40,6,166,A,Novela%20insolven%u010Dn%EDho%20z%E1kona
53165,19,1297119600,52,74,20,20,166,R,Novela%20z.%20-%20energetick%FD%20z%E1kon%20-%20EU
53166,19,1297119600,47,77,17,26,167,R,Novela%20z.%20-%20energetick%FD%20z%E1kon%20-%20EU
53167,19,1297119600,157,0,10,0,167,A,Novela%20z.%20-%20energetick%FD%20z%E1kon%20-%20EU
53168,19,1297119600,147,4,12,4,167,A,Novela%20z.%20-%20energetick%FD%20z%E1kon%20-%20EU
53169,27,1297119600,146,0,18,0,164,A,Novela%20z.%20o%20hornick%E9%20%u010Dinnosti
53170,41,1297119600,132,0,29,0,161,A,Novela%20z.%20o%20pojistn%E9m%20na%20v%u0161eobecn%E9%20zdravotn%ED%20poji%u0161t%u011Bn%ED
53171,41,1297119600,82,22,48,9,161,A,Novela%20z.%20o%20pojistn%E9m%20na%20v%u0161eobecn%E9%20zdravotn%ED%20poji%u0161t%u011Bn%ED
53172,43,1297119600,89,15,37,22,163,A,Novela%20z.%20o%20da%u0148ov%E9m%20poradenstv%ED
53173,45,1297119600,134,0,30,0,164,A,Novela%20z.%20o%20%FAprav%u011B%20vlastnick%FDch%20vztah%u016F%20k%20p%u016Fd%u011B
53174,0,1297119600,118,1,4,1,124,A,%20
53175,0,1297206000,67,17,69,2,155,R,Po%u0159ad%20sch%u016Fze
53176,0,1297206000,87,51,2,4,144,A,Po%u0159ad%20sch%u016Fze
53177,0,1297206000,91,31,19,11,152,A,Po%u0159ad%20sch%u016Fze
53178,0,1297206000,130,21,2,1,154,A,Po%u0159ad%20sch%u016Fze
53179,0,1297206000,152,0,3,0,155,A,Po%u0159ad%20sch%u016Fze
53180,0,1297206000,157,0,1,0,158,A,Po%u0159ad%20sch%u016Fze
53181,0,1297206000,158,0,3,0,161,A,%20
53182,1,1297206000,105,73,1,1,180,A,N.z.%20o%20%DA%u0159adu%20pr%E1ce%20%u010Cesk%E9%20republiky
53183,2,1297206000,23,94,29,35,181,R,Novela%20z.%20o%20dani%20z%20p%u0159idan%E9%20hodnoty%20-%20EU
53184,2,1297206000,122,47,10,2,181,A,Novela%20z.%20o%20dani%20z%20p%u0159idan%E9%20hodnoty%20-%20EU
53185,20,1297206000,138,0,36,0,174,A,Novela%20z.%20o%20loteri%EDch
53186,21,1297206000,149,1,24,0,174,A,Novela%20z.%20o%20loteri%EDch
53187,22,1297206000,150,1,23,0,174,A,Novela%20z.%20o%20loteri%EDch
53188,106,1297206000,83,42,11,2,138,A,Novela%20z.%20o%20ochran%u011B%20ve%u0159ejn%E9ho%20zdrav%ED%20-%20EU
53189,0,1297206000,90,37,12,1,140,A,%20
53190,72,1297206000,113,1,29,0,143,A,Prot.k%20Dohod%u011B%20o%20programu%20pracovn%ED%20dovolen%E9%20mezi%20%u010CR%20vl.%20N.Z%E9landu
53191,60,1297206000,112,2,38,0,152,A,R%E1mcov%E1%20doh.%20mezi%20st%E1ty%20EU%20a%20Korejskou%20rep.
53192,60,1297206000,124,1,30,0,155,A,R%E1mcov%E1%20doh.%20mezi%20st%E1ty%20EU%20a%20Korejskou%20rep.
53193,68,1297206000,129,2,25,0,156,A,N%E1vrh%20zm%u011Bny%20%DAmluvy%20o%20odstran%u011Bn%ED%20v%u0161ech%20forem%20diskrim.%20%u017Een
53194,68,1297206000,125,3,25,3,156,A,N%E1vrh%20zm%u011Bny%20%DAmluvy%20o%20odstran%u011Bn%ED%20v%u0161ech%20forem%20diskrim.%20%u017Een
53195,0,1297292400,88,0,2,0,90,A,Po%u0159ad%20sch%u016Fze
53196,101,1297292400,59,30,8,6,103,A,Odpov%u011Bdi%20%u010Dlen%u016F%20vl%E1dy%20na%20p%EDsemn%E9%20interpelace
53197,101,1297292400,51,37,1,0,89,A,Odpov%u011Bdi%20%u010Dlen%u016F%20vl%E1dy%20na%20p%EDsemn%E9%20interpelace
53198,52,1297292400,59,5,27,27,118,R,Po%u017Eadavky%20na%20rozpo%u010Dtov%E9%20r%E1mce
53199,52,1297292400,94,4,16,6,120,A,Po%u017Eadavky%20na%20rozpo%u010Dtov%E9%20r%E1mce
53200,52,1297292400,66,15,15,23,119,A,Po%u017Eadavky%20na%20rozpo%u010Dtov%E9%20r%E1mce
53201,52,1297292400,58,48,7,10,123,R,Po%u017Eadavky%20na%20rozpo%u010Dtov%E9%20r%E1mce
53202,53,1297292400,111,0,16,0,127,A,Prot.%20mezi%20%u010CR%20a%20Belgick%FDm%20kr%E1l.%20o%20zamezen%ED%20dvoj%EDho%20zdan%u011Bn%ED
53203,55,1297292400,116,1,12,1,130,A,Prot.%20o%20zm%u011Bn%u011B%20Doh.%20mezi%20st%E1ty%20ES%20a%20USA%20o%20leteck%E9%20doprav%u011B
53204,56,1297292400,108,1,25,1,135,A,Prot.%20o%20perzistentn%EDch%20organick%FDch%20polutantech
53205,57,1297292400,114,1,23,0,138,A,Sml.mezi%20%u010CR%20a%20vl.%20%u010Cern%E9%20Hory%20o%20v%FDm%u011Bn%u011B%20a%20ochr.%20utaj.informac%ED
53206,58,1297292400,116,1,23,0,140,A,Sml.mezi%20%u010CR%20a%20vl.%20Rumunska%20o%20vz%E1jemn%E9%20ochran%u011B%20utaj.informac%ED
53207,59,1297292400,115,1,26,0,142,A,Sml.mezi%20%u010CR%20a%20Bosnou%20a%20Herc.o%20v%FDm%u011Bn%u011B%20a%20ochr.%20utaj.%20informac%ED
53208,61,1297292400,102,1,40,0,143,A,Prot.%20mezi%20%u010CR%20a%20St%E1tem%20Kuvajt%20o%20podpo%u0159e%20a%20ochran%u011B%20investic
53209,61,1297292400,111,1,32,0,144,A,Prot.%20mezi%20%u010CR%20a%20St%E1tem%20Kuvajt%20o%20podpo%u0159e%20a%20ochran%u011B%20investic
53210,62,1297292400,126,1,21,0,148,A,Doh.mezi%20st%E1ty%20EU%20a%20Norsk.kr%E1l.o%20spolupr.%20v%20obl.dru%u017E.navig.
53211,63,1297292400,127,0,22,0,149,A,Zm%u011Bny%20harmonogramu%20Mezin%E1rodn%ED%20%FAml.%20o%20regulaci%20velryb%E1%u0159stv%ED
53212,64,1297292400,122,0,26,0,148,A,Prot.%20a%20Doh.%20mezi%20%u010CR%20a%20vl%E1dou%20St%E1tu%20Kuvajt%20o%20leteck%E9%20doprav%u011B
53213,65,1297292400,117,1,29,0,147,A,Prot.%20mezi%20%u010CR%20a%20Kaza%u0161skou%20rep.%20o%20podpo%u0159e%20a%20ochr.investic
53214,67,1297292400,126,1,21,0,148,A,Sml.%20mezi%20%u010CR%20a%20Franc.%20rep.%20o%20spolupr.%20v%20oblasti%20ochr.%20obyv.
53215,67,1297292400,75,25,39,9,148,A,Sml.%20mezi%20%u010CR%20a%20Franc.%20rep.%20o%20spolupr.%20v%20oblasti%20ochr.%20obyv.
53216,70,1297292400,123,1,28,0,152,A,Doh.%20o%20zalo%u017Een%ED%20Mezin%E1rodn%ED%20protikorup%u010Dn%ED%20akademie
53217,71,1297292400,127,0,26,0,153,A,Doh.mezi%20%u010CR%20a%20vl.%20Rep.%20Srbsko%20o%20policejn%ED%20spolupr%E1ci
53218,71,1297292400,94,17,35,7,153,A,Doh.mezi%20%u010CR%20a%20vl.%20Rep.%20Srbsko%20o%20policejn%ED%20spolupr%E1ci
53219,81,1297292400,69,35,43,6,153,R,Zpr.%20o%20%u010Dinnosti%20kontroln%ED%20rady%20Grantov%E9%20agent.%20%u010CR%202009%20-%202010
53220,81,1297292400,68,37,46,2,153,R,Zpr.%20o%20%u010Dinnosti%20kontroln%ED%20rady%20Grantov%E9%20agent.%20%u010CR%202009%20-%202010
53221,82,1297292400,48,58,11,3,120,R,Stanoven%ED%20v%FD%u0161e%20odm%u011Bny%20%u010Dlen%u016Fm%20KR%20GA%20%u010CR
53222,82,1297292400,54,49,9,9,121,R,Stanoven%ED%20v%FD%u0161e%20odm%u011Bny%20%u010Dlen%u016Fm%20KR%20GA%20%u010CR
53223,82,1297292400,72,24,16,8,120,A,Stanoven%ED%20v%FD%u0161e%20odm%u011Bny%20%u010Dlen%u016Fm%20KR%20GA%20%u010CR
53224,82,1297292400,68,47,4,4,123,A,Stanoven%ED%20v%FD%u0161e%20odm%u011Bny%20%u010Dlen%u016Fm%20KR%20GA%20%u010CR
53225,107,1297292400,119,1,5,0,125,A,N%E1vrh%20Pravidel%20hospoda%u0159en%ED%20poslaneck%FDch%20klub%u016F%20pro%20rok%202011
53226,99,1297292400,99,0,24,3,126,A,N%E1vrh%20rozpo%u010Dtu%20Pozemkov%E9ho%20fondu%20%u010Cesk%E9%20republiky%20na%20rok%202011
53227,83,1297292400,84,7,29,7,127,A,N%E1vrh%20usnesen%ED%20ke%20z%u0159izov%E1n%ED%20podv%FDbor%u016F%20v%206.%20volebn%EDm%20obdob%ED
53228,84,1297292400,111,3,14,0,128,A,Kontroln%ED%20z%E1v%u011Br%20NK%DA%20z%20kontroln%ED%20akce%20%u010D.%2008/38
53229,80,1297292400,114,0,13,3,130,A,N%E1vrh%20na%20zm%u011Bny%20ve%20slo%u017Een%ED%20org%E1n%u016F%20Poslaneck%E9%20sn%u011Bmovny
53230,80,1297292400,112,0,16,1,129,A,N%E1vrh%20na%20zm%u011Bny%20ve%20slo%u017Een%ED%20org%E1n%u016F%20Poslaneck%E9%20sn%u011Bmovny
53231,85,1297292400,95,0,29,1,125,A,Zpr%E1va%20o%20v%FDvoji%20mal%E9ho%20a%20st%u0159edn%EDho%20podnik%E1n%ED%20v%20roce%202009
53232,0,1297378800,94,28,32,12,166,A,Po%u0159ad%20sch%u016Fze
53233,0,1297378800,93,58,12,5,168,A,Po%u0159ad%20sch%u016Fze
53234,0,1297378800,70,79,12,7,168,R,Po%u0159ad%20sch%u016Fze
53235,78,1297378800,41,108,6,13,168,R,Novela%20z.%20o%20v%FDkonu%20povol%E1n%ED%20autorizovan%FDch%20architekt%u016F
53236,78,1297378800,35,115,8,9,167,R,Novela%20z.%20o%20v%FDkonu%20povol%E1n%ED%20autorizovan%FDch%20architekt%u016F
53237,78,1297378800,122,9,14,22,167,A,Novela%20z.%20o%20v%FDkonu%20povol%E1n%ED%20autorizovan%FDch%20architekt%u016F
53238,79,1297378800,161,0,9,3,173,A,Novela%20z%20-%20ob%u010Dansk%FD%20z%E1kon%EDk
53239,79,1297378800,72,95,6,1,174,R,Novela%20z%20-%20ob%u010Dansk%FD%20z%E1kon%EDk
53240,79,1297378800,157,0,13,4,174,A,Novela%20z%20-%20ob%u010Dansk%FD%20z%E1kon%EDk
53241,79,1297378800,73,97,3,1,174,R,Novela%20z%20-%20ob%u010Dansk%FD%20z%E1kon%EDk
53242,79,1297378800,142,12,15,5,174,A,Novela%20z%20-%20ob%u010Dansk%FD%20z%E1kon%EDk
53243,79,1297378800,170,1,2,1,174,A,Novela%20z%20-%20ob%u010Dansk%FD%20z%E1kon%EDk
53244,79,1297378800,74,92,7,1,174,R,Novela%20z%20-%20ob%u010Dansk%FD%20z%E1kon%EDk
53245,79,1297378800,0,0,174,0,174,R,Novela%20z%20-%20ob%u010Dansk%FD%20z%E1kon%EDk
53246,79,1297378800,73,96,4,1,174,R,Novela%20z%20-%20ob%u010Dansk%FD%20z%E1kon%EDk
53247,79,1297378800,171,0,2,1,174,A,Novela%20z%20-%20ob%u010Dansk%FD%20z%E1kon%EDk
53248,79,1297378800,51,94,26,3,174,R,Novela%20z%20-%20ob%u010Dansk%FD%20z%E1kon%EDk
53249,79,1297378800,71,97,5,1,174,R,Novela%20z%20-%20ob%u010Dansk%FD%20z%E1kon%EDk
53250,79,1297378800,72,94,7,1,174,R,Novela%20z%20-%20ob%u010Dansk%FD%20z%E1kon%EDk
53251,79,1297378800,100,68,4,2,174,A,Novela%20z%20-%20ob%u010Dansk%FD%20z%E1kon%EDk
53252,76,1297378800,138,0,29,0,167,A,Novela%20celn%EDho%20z%E1kona%20-%20EU
53253,76,1297378800,149,0,18,0,167,A,Novela%20celn%EDho%20z%E1kona%20-%20EU
53254,77,1297378800,138,1,26,1,166,A,Novela%20z.%20o%20dr%E1h%E1ch%20-%20EU
53255,77,1297378800,142,1,21,3,167,A,Novela%20z.%20o%20dr%E1h%E1ch%20-%20EU
53256,104,1297378800,123,1,42,1,167,A,Novela%20insolven%u010Dn%EDho%20z%E1kona
53257,104,1297378800,115,4,40,8,167,A,Novela%20insolven%u010Dn%EDho%20z%E1kona
53258,108,1297378800,86,40,35,3,164,A,Vl.n.z.%20o%20st%E1tn%EDm%20dluhopisov%E9m%20programu
53259,32,1297378800,102,14,6,5,127,A,N.z.%20o%20protikomunistick%E9m%20odboji
53260,32,1297378800,30,107,7,5,149,R,N.z.%20o%20protikomunistick%E9m%20odboji
53261,32,1297378800,135,5,5,3,148,A,N.z.%20o%20protikomunistick%E9m%20odboji
53262,32,1297378800,39,72,16,21,148,R,N.z.%20o%20protikomunistick%E9m%20odboji
53263,32,1297378800,87,37,15,9,148,A,N.z.%20o%20protikomunistick%E9m%20odboji
53264,32,1297378800,29,103,7,10,149,R,N.z.%20o%20protikomunistick%E9m%20odboji
53265,32,1297378800,143,1,4,1,149,A,N.z.%20o%20protikomunistick%E9m%20odboji
53266,0,1297378800,115,25,6,4,150,A,%20
53267,0,1300143600,155,1,12,0,168,A,%20
53268,0,1300143600,161,4,11,1,177,A,Po%u0159ad%20sch%u016Fze
53269,0,1300143600,73,32,63,15,183,R,Po%u0159ad%20sch%u016Fze
53270,0,1300143600,79,60,25,19,183,R,Po%u0159ad%20sch%u016Fze
53271,0,1300143600,178,2,3,0,183,A,Po%u0159ad%20sch%u016Fze
53272,0,1300143600,74,62,22,25,183,R,Po%u0159ad%20sch%u016Fze
53273,0,1300143600,73,63,20,27,183,R,Po%u0159ad%20sch%u016Fze
53274,0,1300143600,71,91,13,8,183,R,Po%u0159ad%20sch%u016Fze
53275,0,1300143600,172,2,9,0,183,A,Po%u0159ad%20sch%u016Fze
53276,0,1300143600,159,13,8,3,183,A,Po%u0159ad%20sch%u016Fze
53277,0,1300143600,173,1,6,3,183,A,Po%u0159ad%20sch%u016Fze
53278,0,1300143600,170,2,9,2,183,A,Po%u0159ad%20sch%u016Fze
53279,0,1300143600,177,2,5,0,184,A,Po%u0159ad%20sch%u016Fze
53280,0,1300143600,178,1,5,0,184,A,Po%u0159ad%20sch%u016Fze
53281,0,1300143600,133,7,34,10,184,A,Po%u0159ad%20sch%u016Fze
53282,1,1300143600,100,10,47,25,182,A,N%E1vrh%20na%20zkr%E1cen%ED%20lh%u016Fty%20k%20projedn%E1n%ED%20tisku%20239
53283,101,1300143600,163,0,19,1,183,A,Zpr%E1va%20KV%20o%20p%u0159ek%E1%u017Ek%E1ch%20v%20kontrole%20NK%DA
53284,2,1300143600,107,68,4,1,180,A,N.z.%20o%20%DA%u0159adu%20pr%E1ce%20%u010Cesk%E9%20republiky
53285,3,1300143600,121,11,33,13,178,A,Novela%20z.%20o%20ochran%u011B%20ve%u0159ejn%E9ho%20zdrav%ED%20-%20EU
53286,13,1300143600,67,102,11,0,180,R,Novela%20z.%20o%20d%u016Fchodov%E9m%20poji%u0161t%u011Bn%ED
53287,13,1300143600,70,98,11,1,180,R,Novela%20z.%20o%20d%u016Fchodov%E9m%20poji%u0161t%u011Bn%ED
53288,13,1300143600,164,1,16,0,181,A,Novela%20z.%20o%20d%u016Fchodov%E9m%20poji%u0161t%u011Bn%ED
53289,13,1300143600,98,61,17,3,179,A,Novela%20z.%20o%20d%u016Fchodov%E9m%20poji%u0161t%u011Bn%ED
53290,14,1300143600,59,91,25,1,176,R,Novela%20z.%20-%20z%E1kon%EDk%20pr%E1ce%20-%20EU
53291,14,1300143600,151,0,25,0,176,A,Novela%20z.%20-%20z%E1kon%EDk%20pr%E1ce%20-%20EU
53292,14,1300143600,59,69,35,13,176,R,Novela%20z.%20-%20z%E1kon%EDk%20pr%E1ce%20-%20EU
53293,14,1300143600,67,5,100,0,172,R,Novela%20z.%20-%20z%E1kon%EDk%20pr%E1ce%20-%20EU
53294,14,1300143600,95,58,0,0,153,A,Novela%20z.%20-%20z%E1kon%EDk%20pr%E1ce%20-%20EU
53295,15,1300143600,153,0,6,0,159,A,Novela%20z.%20o%20n%E1vykov%FDch%20l%E1tk%E1ch
53296,15,1300143600,153,0,6,0,159,A,Novela%20z.%20o%20n%E1vykov%FDch%20l%E1tk%E1ch
53297,16,1300143600,142,1,11,0,154,A,Novela%20z.%20o%20soudech%20a%20soudc%EDch
53298,0,1300230000,89,28,28,8,153,A,Po%u0159ad%20sch%u016Fze
53299,0,1300230000,88,12,45,13,158,A,Po%u0159ad%20sch%u016Fze
53300,0,1300230000,96,16,31,17,160,A,Po%u0159ad%20sch%u016Fze
53301,53,1300230000,144,1,20,1,166,A,N%E1vrh%20na%20p%u0159%EDstup%20k%20prohl%E1%u0161en%ED%20o%20vyu%u017E%EDv%E1n%ED%20nosn%FDch%20raket
53302,55,1300230000,142,2,23,3,170,A,Doh.%20mezi%20%u010CR%20a%20vl.%20Austr%E1lie%20o%20leteck%FDch%20slu%u017Eb%E1ch
53303,62,1300230000,139,1,30,1,171,A,Doh.%20mezi%20vl.%20%u010CR%20a%20vl.%20Gruzie%20o%20leteck%FDch%20slu%u017Eb%E1ch
53304,62,1300230000,152,2,18,2,174,A,Doh.%20mezi%20vl.%20%u010CR%20a%20vl.%20Gruzie%20o%20leteck%FDch%20slu%u017Eb%E1ch
53305,19,1300230000,135,2,42,0,179,A,Novela%20z.%20o%20Celn%ED%20spr%E1v%u011B%20%u010CR%20-%20EU
53306,20,1300230000,128,1,52,0,181,A,Novela%20z.%20o%20kolektivn%EDm%20investov%E1n%ED%20-%20EU
53307,20,1300230000,95,10,66,9,180,A,Novela%20z.%20o%20kolektivn%EDm%20investov%E1n%ED%20-%20EU
53308,16,1300230000,106,11,60,5,182,A,Novela%20z.%20o%20soudech%20a%20soudc%EDch
53309,17,1300230000,126,0,50,1,177,A,Novela%20z.%20o%20rostlinol%E9ka%u0159sk%E9%20p%E9%u010Di%20-%20EU
53310,21,1300230000,133,1,42,1,177,A,Novela%20z.%20o%20ochran%u011B%20ovzdu%u0161%ED%20-%20EU
53311,21,1300230000,130,3,44,1,178,A,Novela%20z.%20o%20ochran%u011B%20ovzdu%u0161%ED%20-%20EU
53312,21,1300230000,126,4,44,4,178,A,Novela%20z.%20o%20ochran%u011B%20ovzdu%u0161%ED%20-%20EU
53313,22,1300230000,134,0,45,0,179,A,Novela%20z.%20-%20veterin%E1rn%ED%20z%E1kon%20-%20EU
53314,23,1300230000,94,64,2,1,161,A,N.z.%20o%20p%u0159izn%E1n%ED%20k%20registrovan%E9mu%20majetku
53315,24,1300230000,98,66,1,0,165,A,Novela%20z.%20o%20vysok%FDch%20%u0161kol%E1ch
53316,25,1300230000,110,42,17,2,171,A,Novela%20z.%20o%20trestn%EDm%20%u0159%EDzen%ED%20soudn%EDm%20%28trestn%ED%20%u0159%E1d%29
53317,26,1300230000,90,64,0,0,154,A,Novela%20z.%20o%20zahrani%u010Dn%EDm%20obchodu%20s%20vojensk%FDm%20materi%E1lem
53318,44,1300230000,120,2,43,5,170,A,N%E1vrh%20Rozhodnut%ED%20Evropsk%E9%20rady%20o%20zm%u011Bn%u011B%20Sml.%20o%20fungov%E1n%ED%20EU
53319,44,1300230000,122,2,43,3,170,A,N%E1vrh%20Rozhodnut%ED%20Evropsk%E9%20rady%20o%20zm%u011Bn%u011B%20Sml.%20o%20fungov%E1n%ED%20EU
53320,30,1300230000,130,0,40,1,171,A,Novela%20z.%20o%20podpo%u0159e%20region%E1ln%EDho%20rozvoje
53321,27,1300230000,90,61,2,2,155,A,Novela%20z.%20o%20dan%EDch%20z%20p%u0159%EDjm%u016F
53322,28,1300230000,82,62,11,0,155,A,N.%20z.%20o%20n%E1jemn%E9m%20z%20byt%u016F
53323,29,1300230000,77,62,1,0,140,A,N.z.%20o%20v%20m%EDst%u011B%20a%20%u010Dase%20obvykl%E9m%20n%E1jemn%E9m%20z%20bytu
53324,31,1300230000,112,2,40,0,154,A,Novela%20z.%20o%20rodin%u011B
53325,31,1300230000,53,70,20,11,154,R,Novela%20z.%20o%20rodin%u011B
53326,31,1300230000,139,0,15,2,156,A,Novela%20z.%20o%20rodin%u011B
53327,31,1300230000,141,0,14,1,156,A,Novela%20z.%20o%20rodin%u011B
53328,31,1300230000,71,53,26,6,156,R,Novela%20z.%20o%20rodin%u011B
53329,46,1300230000,111,1,6,0,118,A,Sml.%20mezi%20%u010CR%20a%20%u0160pan%u011Blsk%FDm%20kr%E1l.%20o%20ochran%u011B%20utaj.%20informac%ED
53330,47,1300230000,115,0,0,0,115,A,Sml.%20mezi%20%u010CR%20a%20vl.%20Chorvatsk%E9%20rep.%20o%20ochran%u011B%20utaj.%20informac%ED
53331,48,1300230000,118,0,3,0,121,A,Sml.mezi%20%u010CR%20a%20Radou%20ministr%u016F%20Alb%E1n.rep.%20o%20ochr.utaj.inform.
53332,50,1300230000,121,0,4,0,125,A,Dohoda%20o%20p%u0159evozu%20t%u011Bl%20zem%u0159el%FDch
53333,51,1300230000,111,0,15,0,126,A,Prot.%20mezi%20%u010CR%20a%20Alb%E1nskou%20rep.%20o%20podpo%u0159e%20a%20ochran%u011B%20investic
53334,52,1300230000,113,0,15,0,128,A,Prot.mezi%20%u010CR%20a%20vl.%20B%u011Blorusk%E9%20rep.%20o%20zamezen%ED%20dvoj%EDho%20zdan%u011Bn%ED
53335,54,1300230000,111,0,15,0,126,A,Vl.n.%20na%20souhlas%20s%20ratifikac%ED%20Akt%20Sv%u011Btov%E9%20po%u0161tovn%ED%20unie
53336,58,1300230000,117,0,15,0,132,A,Doh.%20o%20voln%E9m%20obchodu%20mezi%20st%E1ty%20EU%20a%20Korejskou%20rep.
53337,59,1300230000,117,0,13,1,131,A,Z%E1kladn%ED%20dokumenty%20Mezin%E1rodn%ED%20telekom.%20unie%20a%20jejich%20zm%u011Bny
53338,60,1300230000,116,0,14,0,130,A,Meziamerick%E1%20%FAml.%20o%20v%FDkonu%20trestn%EDch%20rozsudk%u016F%20v%20cizin%u011B
53339,61,1300230000,111,0,18,0,129,A,Sml.%20mezi%20%u010CR%20a%20%u0160v%FDc.%20spol.%20radou%20o%20ochr.%20utaj.%20informac%ED
53340,0,1300748400,113,8,12,13,146,A,Po%u0159ad%20sch%u016Fze
53341,0,1300748400,135,7,17,8,167,A,Po%u0159ad%20sch%u016Fze
53342,0,1300748400,140,7,15,10,172,A,Po%u0159ad%20sch%u016Fze
53343,0,1300748400,104,28,26,14,172,A,Po%u0159ad%20sch%u016Fze
53344,0,1300748400,62,89,16,6,173,R,Po%u0159ad%20sch%u016Fze
53345,0,1300748400,151,5,16,1,173,A,Po%u0159ad%20sch%u016Fze
53346,0,1300748400,124,17,16,16,173,A,Po%u0159ad%20sch%u016Fze
53347,0,1300748400,97,29,35,12,173,A,Po%u0159ad%20sch%u016Fze
53348,0,1300748400,133,6,34,2,175,A,Po%u0159ad%20sch%u016Fze
53349,0,1300748400,160,2,12,1,175,A,Po%u0159ad%20sch%u016Fze
53350,5,1300748400,105,16,43,11,175,A,Novela%20z.%20o%20pozemn%EDch%20komunikac%EDch%20-%20EU
53351,39,1300748400,147,10,17,3,177,A,Novela%20z.%20o%20volb%E1ch%20do%20Parlamentu%20%u010CR
53352,41,1300748400,47,80,37,10,174,R,Novela%20z.%20o%20kraj%EDch%20%28krajsk%E9%20z%u0159%EDzen%ED%29
53353,41,1300748400,146,0,26,3,175,A,Novela%20z.%20o%20kraj%EDch%20%28krajsk%E9%20z%u0159%EDzen%ED%29
53354,42,1300748400,86,65,2,2,155,A,Novela%20z.%20o%20poji%u0161%u0165ovnictv%ED
53355,106,1300748400,123,2,9,4,138,A,Informace%20ministra%20zahrani%u010Dn%EDch%20v%u011Bc%ED%20a%20obrany%20o%20situaci%20v%20Libyi
53356,32,1300748400,111,1,24,0,136,A,Novela%20z.%20o%20komoditn%EDch%20burz%E1ch
53357,32,1300748400,87,22,27,1,137,A,Novela%20z.%20o%20komoditn%EDch%20burz%E1ch
53358,33,1300748400,116,0,29,2,147,A,Novela%20z.%20o%20jednac%EDm%20%u0159%E1du%20PS
53359,33,1300748400,117,2,27,2,148,A,Novela%20z.%20o%20jednac%EDm%20%u0159%E1du%20PS
53360,33,1300748400,77,21,40,12,150,A,Novela%20z.%20o%20jednac%EDm%20%u0159%E1du%20PS
53361,33,1300748400,121,1,29,1,152,A,Novela%20z.%20o%20jednac%EDm%20%u0159%E1du%20PS
53362,33,1300748400,67,35,17,11,130,A,Novela%20z.%20o%20jednac%EDm%20%u0159%E1du%20PS
53363,34,1300748400,127,0,17,1,145,A,Novela%20z.%20o%20soudn%EDch%20poplatc%EDch
53364,34,1300748400,73,51,16,5,145,A,Novela%20z.%20o%20soudn%EDch%20poplatc%EDch
53365,34,1300748400,5,1,128,1,135,R,Novela%20z.%20o%20soudn%EDch%20poplatc%EDch
53366,34,1300748400,124,0,3,0,127,A,Novela%20z.%20o%20soudn%EDch%20poplatc%EDch
53367,34,1300748400,70,56,1,3,130,A,Novela%20z.%20o%20soudn%EDch%20poplatc%EDch
53368,36,1300748400,120,0,17,0,137,A,Novela%20z.%20o%20soudnictv%ED%20ve%20v%u011Bcech%20ml%E1de%u017Ee
53369,0,1300834800,85,33,12,9,139,A,Po%u0159ad%20sch%u016Fze
53370,0,1300834800,129,0,11,1,141,A,Po%u0159ad%20sch%u016Fze
53371,107,1300834800,108,19,18,6,151,A,Novela%20z.%20o%20st%E1tn%EDm%20rozpo%u010Dtu%20%u010CR%20na%20rok%202011
53372,107,1300834800,108,26,17,3,154,A,Novela%20z.%20o%20st%E1tn%EDm%20rozpo%u010Dtu%20%u010CR%20na%20rok%202011
53373,67,1300834800,152,1,8,1,162,A,Novela%20z.%20o%20civiln%EDm%20letectv%ED%20-%20EU
53374,67,1300834800,104,24,22,12,162,A,Novela%20z.%20o%20civiln%EDm%20letectv%ED%20-%20EU
53375,67,1300834800,134,7,16,6,163,A,Novela%20z.%20o%20civiln%EDm%20letectv%ED%20-%20EU
53376,67,1300834800,136,8,8,12,164,A,Novela%20z.%20o%20civiln%EDm%20letectv%ED%20-%20EU
53377,67,1300834800,162,1,2,0,165,A,Novela%20z.%20o%20civiln%EDm%20letectv%ED%20-%20EU
53378,65,1300834800,146,0,21,1,168,A,Novela%20z.%20o%20V%DASC
53379,65,1300834800,150,0,17,1,168,A,Novela%20z.%20o%20V%DASC
53380,68,1300834800,142,1,17,7,167,A,Novela%20z.%20o%20platebn%EDm%20styku%20-%20EU
53381,68,1300834800,131,1,27,8,167,A,Novela%20z.%20o%20platebn%EDm%20styku%20-%20EU
53382,68,1300834800,155,0,9,3,167,A,Novela%20z.%20o%20platebn%EDm%20styku%20-%20EU
53383,69,1300834800,149,0,16,2,167,A,Vl.n.z.%20o%20ob%u011Bhu%20bankovek%20a%20minc%ED%20-%20EU
53384,69,1300834800,152,2,11,2,167,A,Vl.n.z.%20o%20ob%u011Bhu%20bankovek%20a%20minc%ED%20-%20EU
53385,70,1300834800,139,0,22,4,165,A,Novela%20z.%20o%20Policii%20%u010CR%20-%20EU
53386,71,1300834800,12,94,52,11,169,R,Novela%20z.%20o%20st%u0159etu%20z%E1jm%u016F
53387,71,1300834800,65,45,41,18,169,R,Novela%20z.%20o%20st%u0159etu%20z%E1jm%u016F
53388,73,1300834800,141,0,26,0,167,A,Novela%20z.%20o%20pojistn%E9m%20na%20v%u0161eobecn%E9%20zdravotn%ED%20poji%u0161t%u011Bn%ED
53389,73,1300834800,80,44,38,7,169,R,Novela%20z.%20o%20pojistn%E9m%20na%20v%u0161eobecn%E9%20zdravotn%ED%20poji%u0161t%u011Bn%ED
53390,73,1300834800,148,1,20,0,169,A,Novela%20z.%20o%20pojistn%E9m%20na%20v%u0161eobecn%E9%20zdravotn%ED%20poji%u0161t%u011Bn%ED
53391,88,1300834800,129,3,37,3,172,A,V%FDro%u010Dn%ED%20zpr%E1va%20o%20%u010Dinnosti%20a%20%FA%u010Detn%ED%20z%E1v%u011Brka%20SFDI%20za%20rok%202009
53392,97,1300834800,121,3,46,2,172,A,Zpr%E1va%20o%20%u017Eivotn%EDm%20prost%u0159ed%ED%20%u010CR%20v%20roce%202009
53393,37,1300834800,129,1,42,1,173,A,Novela%20z.%20o%20ochran%u011B%20utaj.%20informac%ED%20a%20o%20bezpe%u010Dnostn%ED%20zp%u016Fsob.
53394,40,1300834800,68,63,6,3,140,R,Novela%20z.%20-%20trestn%ED%20z%E1kon%EDk
53395,40,1300834800,107,27,13,7,154,A,Novela%20z.%20-%20trestn%ED%20z%E1kon%EDk
53396,40,1300834800,87,68,4,1,160,A,Novela%20z.%20-%20trestn%ED%20z%E1kon%EDk
53397,89,1300834800,86,13,47,14,160,A,V%FDro%u010Dn%ED%20zpr%E1va%20o%20hospoda%u0159en%ED%20%u010Cesk%E9ho%20rozhlasu%20za%20rok%202009
53398,90,1300834800,79,22,16,10,127,A,V%FDro%u010Dn%ED%20zpr%E1va%20o%20hospoda%u0159en%ED%20%u010Cesk%E9%20televize%20v%20roce%202009
53399,91,1300834800,86,13,25,8,132,A,V%FDro%u010Dn%ED%20zpr%E1va%20o%20%u010Dinnosti%20a%20hospoda%u0159en%ED%20%u010CTK%20v%20roce%202009
53400,93,1300834800,117,9,14,6,146,A,Zpr%E1va%20o%20stavu%20vys%EDl%E1n%ED%20a%20%u010Dinnosti%20Rady%20RTV%20za%20rok%202009
53401,94,1300834800,79,25,32,13,149,A,V%FDro%u010Dn%ED%20zpr%E1va%20o%20%u010Dinnosti%20%u010Cesk%E9%20televize%20v%20roce%202009
53402,95,1300834800,76,45,24,9,154,R,V%FDro%u010Dn%ED%20zpr%E1va%20Rady%20%u010Cesk%E9ho%20rozhlasu%20za%20rok%202009
53403,95,1300834800,99,26,28,4,157,A,V%FDro%u010Dn%ED%20zpr%E1va%20Rady%20%u010Cesk%E9ho%20rozhlasu%20za%20rok%202009
53404,95,1300834800,86,50,12,4,152,A,V%FDro%u010Dn%ED%20zpr%E1va%20Rady%20%u010Cesk%E9ho%20rozhlasu%20za%20rok%202009
53405,96,1300834800,88,49,13,5,155,A,Zpr.%20o%20pln%u011Bn%ED%20st%E1tn%EDho%20rozpo%u010Dtu%20%u010CR%20za%201.%20pololet%ED%202010
53406,74,1300834800,90,11,36,20,157,A,N%E1vrh%20na%20odvol%E1n%ED%20%u010Dlen%u016F%20DR%20SFDI
53407,75,1300834800,110,9,14,24,157,A,N%E1vrh%20na%20odvol%E1n%ED%20%u010Dlen%u016F%20DR%20SZIF
53408,76,1300834800,98,10,22,27,157,A,N%E1vrh%20na%20odvol%E1n%ED%20%u010Dlen%u016F%20DR%20PF%20%u010CR
53409,76,1300834800,93,8,34,22,157,A,N%E1vrh%20na%20odvol%E1n%ED%20%u010Dlen%u016F%20DR%20PF%20%u010CR
53410,77,1300834800,111,10,22,16,159,A,N%E1vrh%20na%20jmenov%E1n%ED%20%u010Dlen%u016F%20KR%20GA%20%u010CR
53411,78,1300834800,85,9,41,23,158,A,N%E1vrh%20na%20jmenov%E1n%ED%20%u010Dlen%u016F%20KR%20TA%20%u010CR
53412,108,1300834800,113,7,32,10,162,A,Informace%20o%20pozici%20%u010CR%20na%20jedn%E1n%ED%20Evropsk%E9%20Rady
53413,57,1300834800,121,1,35,3,160,A,Doh.%20o%20partnerstv%ED
53414,49,1300834800,113,1,42,3,159,A,Doh.mezi%20ES%20a%20Jihoafric.rep.o%20obchodu%2Crozvoji%20a%20spolupr%E1ci
53415,56,1300834800,118,1,35,4,158,A,Doh.%20o%20v%FDsad%E1ch%20a%20imunit%E1ch%20Mez.%20trest.%20soudu
53416,0,1300921200,74,0,5,0,79,A,Po%u0159ad%20sch%u016Fze
53417,18,1300921200,88,0,24,0,112,A,Novela%20z.%20o%20vinohradnictv%ED%20a%20vina%u0159stv%ED%20-%20EU
53418,45,1300921200,108,0,17,0,125,A,Spole%u010Dn%E1%20zem%u011Bd%u011Blsk%E1%20politika%20do%20roku%202020
53419,0,1300921200,124,1,15,0,140,A,%20
53420,0,1300921200,69,39,37,21,166,R,Po%u0159ad%20sch%u016Fze
53421,0,1301007600,94,15,21,18,148,A,Po%u0159ad%20sch%u016Fze
53422,105,1301007600,4,105,31,33,173,R,Novela%20z.%20o%20nel%E9ka%u0159sk%FDch%20zdravotnick%FDch%20povol%E1n%EDch
53423,105,1301007600,167,0,3,3,173,A,Novela%20z.%20o%20nel%E9ka%u0159sk%FDch%20zdravotnick%FDch%20povol%E1n%EDch
53424,79,1301007600,149,0,20,2,171,A,N%E1vrh%20na%20zm%u011Bny%20ve%20slo%u017Een%ED%20org%E1n%u016F%20Poslaneck%E9%20sn%u011Bmovny
53425,79,1301007600,154,0,16,1,171,A,N%E1vrh%20na%20zm%u011Bny%20ve%20slo%u017Een%ED%20org%E1n%u016F%20Poslaneck%E9%20sn%u011Bmovny
53426,66,1301007600,142,1,26,0,169,A,Novela%20z.%20o%20pozemn%EDch%20komunikac%EDch%20-%20EU
53427,66,1301007600,148,1,20,0,169,A,Novela%20z.%20o%20pozemn%EDch%20komunikac%EDch%20-%20EU
53428,66,1301007600,62,85,22,1,170,R,Novela%20z.%20o%20pozemn%EDch%20komunikac%EDch%20-%20EU
53429,66,1301007600,119,8,27,16,170,A,Novela%20z.%20o%20pozemn%EDch%20komunikac%EDch%20-%20EU
53430,66,1301007600,66,86,17,1,170,R,Novela%20z.%20o%20pozemn%EDch%20komunikac%EDch%20-%20EU
53431,66,1301007600,64,67,25,14,170,R,Novela%20z.%20o%20pozemn%EDch%20komunikac%EDch%20-%20EU
53432,66,1301007600,65,89,14,2,170,R,Novela%20z.%20o%20pozemn%EDch%20komunikac%EDch%20-%20EU
53433,66,1301007600,156,1,13,0,170,A,Novela%20z.%20o%20pozemn%EDch%20komunikac%EDch%20-%20EU
53434,66,1301007600,155,1,14,0,170,A,Novela%20z.%20o%20pozemn%EDch%20komunikac%EDch%20-%20EU
53435,66,1301007600,129,7,21,13,170,A,Novela%20z.%20o%20pozemn%EDch%20komunikac%EDch%20-%20EU
53436,66,1301007600,41,96,15,18,170,R,Novela%20z.%20o%20pozemn%EDch%20komunikac%EDch%20-%20EU
53437,66,1301007600,155,2,12,1,170,A,Novela%20z.%20o%20pozemn%EDch%20komunikac%EDch%20-%20EU
53438,64,1301007600,70,32,40,28,170,R,Novela%20z.%20o%20ochran%u011B%20ve%u0159ejn%E9ho%20zdrav%ED%20-%20EU
53439,64,1301007600,104,34,19,12,169,A,Novela%20z.%20o%20ochran%u011B%20ve%u0159ejn%E9ho%20zdrav%ED%20-%20EU
53440,64,1301007600,34,95,29,11,169,R,Novela%20z.%20o%20ochran%u011B%20ve%u0159ejn%E9ho%20zdrav%ED%20-%20EU
53441,64,1301007600,99,42,9,20,170,A,Novela%20z.%20o%20ochran%u011B%20ve%u0159ejn%E9ho%20zdrav%ED%20-%20EU
53442,64,1301007600,158,2,8,2,170,A,Novela%20z.%20o%20ochran%u011B%20ve%u0159ejn%E9ho%20zdrav%ED%20-%20EU
53443,64,1301007600,121,17,14,18,170,A,Novela%20z.%20o%20ochran%u011B%20ve%u0159ejn%E9ho%20zdrav%ED%20-%20EU
53444,64,1301007600,100,15,31,24,170,A,Novela%20z.%20o%20ochran%u011B%20ve%u0159ejn%E9ho%20zdrav%ED%20-%20EU
53445,64,1301007600,124,12,15,19,170,A,Novela%20z.%20o%20ochran%u011B%20ve%u0159ejn%E9ho%20zdrav%ED%20-%20EU
53446,63,1301007600,150,0,15,1,166,A,Novela%20z.%20o%20ochran%u011B%20ovzdu%u0161%ED
53447,63,1301007600,157,0,10,0,167,A,Novela%20z.%20o%20ochran%u011B%20ovzdu%u0161%ED
53448,63,1301007600,157,0,10,0,167,A,Novela%20z.%20o%20ochran%u011B%20ovzdu%u0161%ED
53449,63,1301007600,55,86,14,11,166,R,Novela%20z.%20o%20ochran%u011B%20ovzdu%u0161%ED
53450,63,1301007600,157,0,9,0,166,A,Novela%20z.%20o%20ochran%u011B%20ovzdu%u0161%ED
53451,63,1301007600,143,1,10,13,167,A,Novela%20z.%20o%20ochran%u011B%20ovzdu%u0161%ED
53452,86,1301007600,54,7,41,50,152,R,Odvol%E1n%ED%20poslance%20D.%20Ratha%20proti%20rozhodnut%ED%20MIV
53453,86,1301007600,79,46,22,6,153,A,Odvol%E1n%ED%20poslance%20D.%20Ratha%20proti%20rozhodnut%ED%20MIV
53454,87,1301007600,69,34,36,14,153,R,%u017D%E1dost%20k%20trestn%EDmu%20st%EDh%E1n%ED%20poslance%20Stanislava%20Humla
53455,92,1301007600,120,0,31,0,151,A,Zpr%E1va%20o%20petic%EDch%20za%20obdob%ED%20od%201.%201.%20do%2030.%206.%202010
53456,98,1301007600,99,21,30,0,150,A,Rozh.%20vl.%20o%20p%u0159eletech%20ozbrojen%FDch%20sil%20p%u0159es%20%FAzem%ED%20%u010CR%20-%202011
53457,99,1301007600,112,1,34,1,148,A,Inf.%20o%20vojen.%20cvi%u010Den%EDch%20A%u010CR%20se%20zahr.%20partnery%20v%20roce%202011
53458,100,1301007600,116,0,32,0,148,A,Zpr%E1va%20o%20%u010Dinnosti%20finan%u010Dn%EDho%20arbitra%20za%20rok%202010
53459,0,1301007600,105,4,34,0,143,A,%20
53460,0,1303768800,171,0,13,0,184,A,%20
53461,0,1303768800,131,0,18,0,149,A,%20
53462,0,1303768800,99,23,33,25,180,A,%20
53463,1,1303768800,0,0,194,0,194,R,N%E1vrh%20na%20vysloven%ED%20ned%u016Fv%u011Bry%20vl%E1d%u011B%20%u010Cesk%E9%20republiky
53464,1,1303768800,82,98,8,8,196,R,N%E1vrh%20na%20vysloven%ED%20ned%u016Fv%u011Bry%20vl%E1d%u011B%20%u010Cesk%E9%20republiky
53465,0,1303855200,91,7,65,8,171,A,Po%u0159ad%20sch%u016Fze
53466,0,1303855200,170,2,3,1,176,A,Po%u0159ad%20sch%u016Fze
53467,0,1303855200,171,1,3,1,176,A,Po%u0159ad%20sch%u016Fze
53468,0,1303855200,172,1,3,1,177,A,Po%u0159ad%20sch%u016Fze
53469,0,1303855200,126,35,8,8,177,A,Po%u0159ad%20sch%u016Fze
53470,0,1303855200,125,40,5,7,177,A,Po%u0159ad%20sch%u016Fze
53471,0,1303855200,106,15,32,25,178,A,Po%u0159ad%20sch%u016Fze
53472,0,1303855200,173,0,3,2,178,A,Po%u0159ad%20sch%u016Fze
53473,0,1303855200,147,0,26,5,178,A,Po%u0159ad%20sch%u016Fze
53474,0,1303855200,149,0,24,5,178,A,Po%u0159ad%20sch%u016Fze
53475,0,1303855200,48,4,119,7,178,R,Po%u0159ad%20sch%u016Fze
53476,0,1303855200,106,16,35,22,179,A,Po%u0159ad%20sch%u016Fze
53477,0,1303855200,107,20,30,22,179,A,Po%u0159ad%20sch%u016Fze
53478,0,1303855200,101,22,31,23,177,A,%20
53479,0,1303855200,143,26,6,4,179,A,Po%u0159ad%20sch%u016Fze
53480,0,1303855200,95,26,36,22,179,A,%20
53481,46,1303855200,122,0,59,0,181,A,Novela%20z.%20o%20rozpo%u010Dtov%FDch%20pravidlech
53482,38,1303855200,131,1,49,0,181,A,Novela%20z.%20o%20uv%E1d%u011Bn%ED%20biocidn%EDch%20p%u0159%EDpravk%u016F%20na%20trh
53483,69,1303855200,132,1,38,0,171,A,Prot.k%20Dohod%u011B%20o%20programu%20pracovn%ED%20dovolen%E9%20mezi%20%u010CR%20vl.%20N.Z%E9landu
53484,58,1303855200,139,1,33,2,175,A,R%E1mcov%E1%20doh.%20mezi%20st%E1ty%20EU%20a%20Korejskou%20rep.
53485,66,1303855200,149,2,26,0,177,A,N%E1vrh%20zm%u011Bny%20%DAmluvy%20o%20odstran%u011Bn%ED%20v%u0161ech%20forem%20diskrim.%20%u017Een
53486,32,1303855200,149,2,23,0,174,A,Novela%20z.%20o%20n%E1mo%u0159n%ED%20plavb%u011B%20-%20EU
53487,32,1303855200,69,65,31,9,174,R,Novela%20z.%20o%20n%E1mo%u0159n%ED%20plavb%u011B%20-%20EU
53488,32,1303855200,35,82,49,8,174,R,Novela%20z.%20o%20n%E1mo%u0159n%ED%20plavb%u011B%20-%20EU
53489,32,1303855200,122,5,45,2,174,A,Novela%20z.%20o%20n%E1mo%u0159n%ED%20plavb%u011B%20-%20EU
53490,34,1303855200,151,0,22,0,173,A,Novela%20z.%20o%20silni%u010Dn%EDm%20provozu%20-%20EU
53491,34,1303855200,97,15,47,14,173,A,Novela%20z.%20o%20silni%u010Dn%EDm%20provozu%20-%20EU
53492,27,1303855200,143,0,26,0,169,A,Novela%20z.%20o%20zahrani%u010Dn%EDm%20obchodu%20s%20vojensk%FDm%20materi%E1lem%20-%20EU
53493,27,1303855200,132,2,34,0,168,A,Novela%20z.%20o%20zahrani%u010Dn%EDm%20obchodu%20s%20vojensk%FDm%20materi%E1lem%20-%20EU
53494,0,1303941600,86,0,5,0,91,A,Po%u0159ad%20sch%u016Fze
53495,0,1303941600,80,1,8,2,91,A,Po%u0159ad%20sch%u016Fze
53496,109,1303941600,44,27,38,2,111,R,Odpov%u011Bdi%20%u010Dlen%u016F%20vl%E1dy%20na%20p%EDsemn%E9%20interpelace
53497,109,1303941600,41,17,51,3,112,R,Odpov%u011Bdi%20%u010Dlen%u016F%20vl%E1dy%20na%20p%EDsemn%E9%20interpelace
53498,109,1303941600,44,43,1,4,92,R,Odpov%u011Bdi%20%u010Dlen%u016F%20vl%E1dy%20na%20p%EDsemn%E9%20interpelace
53499,57,1303941600,62,20,31,15,128,R,Sm%u011Brnice%20EP%20a%20Rady%20o%20pou%u017E%EDv%E1n%ED%20%FAdaj%u016F%20ze%20jmenn%E9%20evid.%20cest.
53500,57,1303941600,91,1,4,19,115,A,Sm%u011Brnice%20EP%20a%20Rady%20o%20pou%u017E%EDv%E1n%ED%20%FAdaj%u016F%20ze%20jmenn%E9%20evid.%20cest.
53501,59,1303941600,90,1,26,2,119,A,Prot.%20mezi%20%u010CR%20a%20St%E1tem%20Kuvajt%20o%20podpo%u0159e%20a%20ochran%u011B%20investic
53502,60,1303941600,96,0,25,0,121,A,Prot.%20a%20Doh.%20mezi%20%u010CR%20a%20vl%E1dou%20St%E1tu%20Kuvajt%20o%20leteck%E9%20doprav%u011B
53503,61,1303941600,97,0,23,2,122,A,Doh.mezi%20st%E1ty%20EU%20a%20Norsk.kr%E1l.o%20spolupr.%20v%20obl.dru%u017E.navig.
53504,62,1303941600,102,0,21,0,123,A,Zm%u011Bny%20harmonogramu%20Mezin%E1rodn%ED%20%FAml.%20o%20regulaci%20velryb%E1%u0159stv%ED
53505,63,1303941600,99,0,22,0,121,A,Prot.%20mezi%20%u010CR%20a%20Kaza%u0161skou%20rep.%20o%20podpo%u0159e%20a%20ochr.investic
53506,65,1303941600,92,0,30,0,122,A,Sml.%20mezi%20%u010CR%20a%20Franc.%20rep.%20o%20spolupr.%20v%20oblasti%20ochr.%20obyv.
53507,67,1303941600,95,0,30,0,125,A,Doh.%20o%20zalo%u017Een%ED%20Mezin%E1rodn%ED%20protikorup%u010Dn%ED%20akademie
53508,68,1303941600,95,0,29,1,125,A,Doh.mezi%20%u010CR%20a%20vl.%20Rep.%20Srbsko%20o%20policejn%ED%20spolupr%E1ci
53509,70,1303941600,92,0,32,0,124,A,Sml.%20mezi%20%u010CR%20a%20vl.%20Rep.%20Kazachst%E1n%20p%u0159eb%EDr%E1n%ED%20osob
53510,71,1303941600,90,0,35,0,125,A,Doh.mezi%20%u010CR%20a%20Irskem%20o%20podpo%u0159e%20a%20vz%E1jemn%E9%20ochran%u011B%20investic
53511,72,1303941600,103,0,23,0,126,A,Evropsk%E1%20doh.%20o%20mezin%E1rodn%ED%20p%u0159eprav%u011B%20nebezpe%u010Dn%FDch%20v%u011Bc%ED
53512,72,1303941600,54,29,36,7,126,R,Evropsk%E1%20doh.%20o%20mezin%E1rodn%ED%20p%u0159eprav%u011B%20nebezpe%u010Dn%FDch%20v%u011Bc%ED
53513,72,1303941600,89,4,32,1,126,A,Evropsk%E1%20doh.%20o%20mezin%E1rodn%ED%20p%u0159eprav%u011B%20nebezpe%u010Dn%FDch%20v%u011Bc%ED
53514,35,1304028000,126,2,21,0,149,A,Novela%20z.%20-%20atomov%FD%20z%E1kon%20-%20EU
53515,35,1304028000,109,5,34,3,151,A,Novela%20z.%20-%20atomov%FD%20z%E1kon%20-%20EU
53516,45,1304028000,140,0,18,0,158,A,Novela%20z.%20-%20atomov%FD%20z%E1kon
53517,45,1304028000,130,3,25,0,158,A,Novela%20z.%20-%20atomov%FD%20z%E1kon
53518,10,1304028000,51,77,28,4,160,R,Novela%20z.%20-%20energetick%FD%20z%E1kon%20-%20EU
53519,10,1304028000,127,3,0,2,132,A,Novela%20z.%20-%20energetick%FD%20z%E1kon%20-%20EU
53520,42,1304028000,119,1,23,1,144,A,Novela%20z.%20o%20inf.%20syst%E9mech%20ve%u0159.%20spr%E1vy%20a%20o%20elektron.%20%FAkonech
53521,42,1304028000,53,57,32,2,144,R,Novela%20z.%20o%20inf.%20syst%E9mech%20ve%u0159.%20spr%E1vy%20a%20o%20elektron.%20%FAkonech
53522,42,1304028000,73,22,45,4,144,A,Novela%20z.%20o%20inf.%20syst%E9mech%20ve%u0159.%20spr%E1vy%20a%20o%20elektron.%20%FAkonech
53523,42,1304028000,121,0,3,1,125,A,Novela%20z.%20o%20inf.%20syst%E9mech%20ve%u0159.%20spr%E1vy%20a%20o%20elektron.%20%FAkonech
53524,42,1304028000,75,33,20,2,130,A,Novela%20z.%20o%20inf.%20syst%E9mech%20ve%u0159.%20spr%E1vy%20a%20o%20elektron.%20%FAkonech
53525,52,1304028000,93,1,31,0,125,A,Novela%20z.%20o%20zvl%E1%u0161tn%ED%20ochran%u011B%20sv%u011Bdka
53526,52,1304028000,20,89,18,9,136,R,Novela%20z.%20o%20zvl%E1%u0161tn%ED%20ochran%u011B%20sv%u011Bdka
53527,52,1304028000,122,2,13,0,137,A,Novela%20z.%20o%20zvl%E1%u0161tn%ED%20ochran%u011B%20sv%u011Bdka
53528,52,1304028000,118,3,16,0,137,A,Novela%20z.%20o%20zvl%E1%u0161tn%ED%20ochran%u011B%20sv%u011Bdka
53529,64,1304028000,119,0,14,0,133,A,%DAmluva%20o%20kazetov%E9%20munici
53530,104,1304028000,108,1,22,1,132,A,Inf.%20o%20vojensk%FDch%20cvi%u010Den%EDch%20A%u010CR%20%u010Dervenec%20-%20prosinec%202010
53531,105,1304028000,83,19,29,0,131,A,Inf.%20o%20p%u0159eletech%20a%20pr%u016Fjezdech%20ozbroj.%20sil%20ve%202.%20pol.%202010
53532,25,1304028000,101,0,32,1,134,A,Novela%20z.%20o%20st%E1tn%ED%20pam%E1tkov%E9%20p%E9%u010Di
53533,25,1304028000,108,1,26,0,135,A,Novela%20z.%20o%20st%E1tn%ED%20pam%E1tkov%E9%20p%E9%u010Di
53534,26,1304028000,100,1,33,0,134,A,Novela%20z.%20o%20St%E1tn%EDm%20zem%u011Bd.%20interven%u010Dn%EDm%20fondu
53535,26,1304028000,95,2,37,1,135,A,Novela%20z.%20o%20St%E1tn%EDm%20zem%u011Bd.%20interven%u010Dn%EDm%20fondu
53536,26,1304028000,70,16,45,4,135,A,Novela%20z.%20o%20St%E1tn%EDm%20zem%u011Bd.%20interven%u010Dn%EDm%20fondu
53537,37,1304028000,107,0,2,0,109,A,Vl.n.z.%20o%20chemick%FDch%20l%E1tk%E1ch%20%28chemick%FD%20z%E1kon%29%20-%20EU
53538,0,1304373600,105,73,4,5,187,A,%20
53539,0,1304373600,101,76,11,0,188,A,Po%u0159ad%20sch%u016Fze
53540,0,1304373600,120,40,20,8,188,A,Po%u0159ad%20sch%u016Fze
53541,0,1304373600,181,2,3,2,188,A,Po%u0159ad%20sch%u016Fze
53542,0,1304373600,169,0,19,0,188,A,Po%u0159ad%20sch%u016Fze
53543,0,1304373600,184,1,3,0,188,A,Po%u0159ad%20sch%u016Fze
53544,0,1304373600,171,1,15,1,188,A,Po%u0159ad%20sch%u016Fze
53545,0,1304373600,86,79,12,12,189,R,Po%u0159ad%20sch%u016Fze
53546,0,1304373600,66,72,37,14,189,R,Po%u0159ad%20sch%u016Fze
53547,0,1304373600,80,104,3,2,189,R,Po%u0159ad%20sch%u016Fze
53548,0,1304373600,113,67,5,4,189,A,Po%u0159ad%20sch%u016Fze
53549,0,1304373600,182,0,7,0,189,A,Po%u0159ad%20sch%u016Fze
53550,0,1304373600,170,2,14,3,189,A,Po%u0159ad%20sch%u016Fze
53551,0,1304373600,163,5,14,6,188,A,%20
53552,0,1304373600,105,72,2,1,180,A,Po%u0159ad%20sch%u016Fze
53553,2,1304373600,159,9,15,4,187,A,Novela%20z.%20o%20provozu%20na%20pozemn%EDch%20komunikac%EDch
53554,3,1304373600,158,0,27,0,185,A,Novela%20z.%20o%20dr%E1h%E1ch%20-%20EU
53555,4,1304373600,67,73,40,6,186,R,Novela%20z.%20o%20v%FDkonu%20povol%E1n%ED%20autorizovan%FDch%20architekt%u016F
53556,4,1304373600,150,0,33,4,187,A,Novela%20z.%20o%20v%FDkonu%20povol%E1n%ED%20autorizovan%FDch%20architekt%u016F
53557,5,1304373600,53,127,10,2,192,R,Novela%20z%20-%20ob%u010Dansk%FD%20z%E1kon%EDk
53558,5,1304373600,108,73,8,3,192,A,Novela%20z%20-%20ob%u010Dansk%FD%20z%E1kon%EDk
53559,39,1304373600,75,95,0,0,170,R,Novela%20z.%20o%20ve%u0159ejn%E9m%20zdravotn%EDm%20poji%u0161t%u011Bn%ED%20-%20EU
53560,39,1304373600,74,95,2,1,172,R,Novela%20z.%20o%20ve%u0159ejn%E9m%20zdravotn%EDm%20poji%u0161t%u011Bn%ED%20-%20EU
53561,39,1304373600,83,75,12,5,175,R,Novela%20z.%20o%20ve%u0159ejn%E9m%20zdravotn%EDm%20poji%u0161t%u011Bn%ED%20-%20EU
53562,39,1304373600,79,104,4,0,187,R,Novela%20z.%20o%20ve%u0159ejn%E9m%20zdravotn%EDm%20poji%u0161t%u011Bn%ED%20-%20EU
53563,39,1304373600,77,107,3,0,187,R,Novela%20z.%20o%20ve%u0159ejn%E9m%20zdravotn%EDm%20poji%u0161t%u011Bn%ED%20-%20EU
53564,39,1304373600,77,106,4,0,187,R,Novela%20z.%20o%20ve%u0159ejn%E9m%20zdravotn%EDm%20poji%u0161t%u011Bn%ED%20-%20EU
53565,39,1304373600,123,10,28,22,183,A,Novela%20z.%20o%20ve%u0159ejn%E9m%20zdravotn%EDm%20poji%u0161t%u011Bn%ED%20-%20EU
53566,39,1304373600,108,76,3,0,187,A,Novela%20z.%20o%20ve%u0159ejn%E9m%20zdravotn%EDm%20poji%u0161t%u011Bn%ED%20-%20EU
53567,0,1304460000,79,61,7,4,151,A,Po%u0159ad%20sch%u016Fze
53568,0,1304460000,88,62,7,1,158,A,Po%u0159ad%20sch%u016Fze
53569,49,1304460000,71,98,9,1,179,R,Vl.n.z.%20v%20souvislosti%20s%20%FAsporn%FDmi%20opat%u0159en%EDmi%20v%20p%u016Fsob.%20MPSV
53570,49,1304460000,166,3,11,1,181,A,Vl.n.z.%20v%20souvislosti%20s%20%FAsporn%FDmi%20opat%u0159en%EDmi%20v%20p%u016Fsob.%20MPSV
53571,0,1304546400,80,48,3,5,136,A,Po%u0159ad%20sch%u016Fze
53572,0,1304546400,130,2,5,1,138,A,Po%u0159ad%20sch%u016Fze
53573,0,1304546400,133,1,2,3,139,A,Po%u0159ad%20sch%u016Fze
53574,100,1304546400,134,0,8,0,142,A,Zpr%E1va%20o%20kontrole%20v%FDro%u010Dn%EDch%20fin.%20zpr%E1v%20pol.%20stran%20a%20hnut%ED%202010
53575,101,1304546400,128,1,12,0,141,A,Dopln%u011Bn%ED%20v%FDro%u010Dn%EDch%20fin.%20zpr%E1v%20pol.%20stran%20a%20hnut%ED%202005-2009
53576,99,1304546400,128,1,17,2,148,A,N%E1vrh%20harmonogramu%20projedn%E1v%E1n%ED%20St%E1tn%EDho%20z%E1v%u011Bre%u010Dn%E9ho%20%FA%u010Dtu%202010
53577,106,1304546400,124,0,25,0,149,A,Zpr%E1va%20o%20petic%EDch%20za%20obdob%ED%20od%201.%207.%202010%20do%2031.%2012.%202010
53578,107,1304546400,101,2,45,2,150,A,V%FDro%u010Dn%ED%20zpr%E1va%20o%20%u010Dinnosti%20a%20%FA%u010Detn%ED%20z%E1v%u011Brka%20SFDI%20za%20rok%202010
53579,108,1304546400,119,0,29,3,151,A,Zpr%E1va%20o%20stavu%20vys%EDl%E1n%ED%20a%20%u010Dinnosti%20Rady%20RTV%20za%20rok%202010
53580,40,1304546400,121,0,30,0,151,A,Novela%20z.%20o%20ve%u0159ejn%FDch%20zak%E1zk%E1ch%20-%20EU
53581,93,1304546400,127,0,31,0,158,A,N%E1vrh%20na%20zm%u011Bny%20ve%20slo%u017Een%ED%20org%E1n%u016F%20Poslaneck%E9%20sn%u011Bmovny
53582,93,1304546400,133,1,25,0,159,A,N%E1vrh%20na%20zm%u011Bny%20ve%20slo%u017Een%ED%20org%E1n%u016F%20Poslaneck%E9%20sn%u011Bmovny
53583,95,1304546400,130,3,26,0,159,A,N%E1vh%20na%20volbu%20p%u0159edsedy%20DR%20SZIF
53584,96,1304546400,130,2,27,0,159,A,N%E1vrh%20na%20volbu%20%u010Dlen%u016F%20DR%20SZIF
53585,97,1304546400,140,2,17,0,159,A,N%E1vrh%20na%20volbu%20%u010Dlen%u016F%20DR%20PF%20%u010CR
53586,0,1304632800,101,12,30,7,150,A,Po%u0159ad%20sch%u016Fze
53587,0,1304632800,89,16,29,18,152,A,Po%u0159ad%20sch%u016Fze
53588,0,1304632800,111,12,13,16,152,A,Po%u0159ad%20sch%u016Fze
53589,102,1304632800,135,1,22,1,159,A,Zpr%E1va%20o%20inflaci%20-%20leden%202011
53590,102,1304632800,128,2,33,4,167,A,Zpr%E1va%20o%20inflaci%20-%20leden%202011
53591,103,1304632800,121,7,32,7,167,A,Ro%u010Dn%ED%20zpr%E1va%20o%20v%FDsledku%20hospoda%u0159en%ED%20%u010CNB%20za%20rok%202010
53592,28,1304632800,151,0,19,0,170,A,Novela%20z.%20o%20hospoda%u0159en%ED%20energi%ED%20-%20EU
53593,28,1304632800,143,3,23,1,170,A,Novela%20z.%20o%20hospoda%u0159en%ED%20energi%ED%20-%20EU
53594,78,1304632800,46,72,40,9,167,R,Novela%20z.%20-%20energetick%FD%20z%E1kon%20-%20EU
53595,78,1304632800,53,75,31,5,164,R,Novela%20z.%20-%20energetick%FD%20z%E1kon%20-%20EU
53596,78,1304632800,46,71,30,18,165,R,Novela%20z.%20-%20energetick%FD%20z%E1kon%20-%20EU
53597,78,1304632800,143,5,13,4,165,A,Novela%20z.%20-%20energetick%FD%20z%E1kon%20-%20EU
53598,78,1304632800,142,6,12,5,165,A,Novela%20z.%20-%20energetick%FD%20z%E1kon%20-%20EU
53599,78,1304632800,90,50,13,11,164,A,Novela%20z.%20-%20energetick%FD%20z%E1kon%20-%20EU
53600,78,1304632800,147,1,11,6,165,A,Novela%20z.%20-%20energetick%FD%20z%E1kon%20-%20EU
53601,78,1304632800,87,48,16,14,165,A,Novela%20z.%20-%20energetick%FD%20z%E1kon%20-%20EU
53602,78,1304632800,67,64,19,15,165,R,Novela%20z.%20-%20energetick%FD%20z%E1kon%20-%20EU
53603,78,1304632800,150,1,9,4,164,A,Novela%20z.%20-%20energetick%FD%20z%E1kon%20-%20EU
53604,78,1304632800,63,68,17,17,165,R,Novela%20z.%20-%20energetick%FD%20z%E1kon%20-%20EU
53605,78,1304632800,49,94,13,9,165,R,Novela%20z.%20-%20energetick%FD%20z%E1kon%20-%20EU
53606,78,1304632800,134,15,11,5,165,A,Novela%20z.%20-%20energetick%FD%20z%E1kon%20-%20EU
53607,78,1304632800,5,100,37,23,165,R,Novela%20z.%20-%20energetick%FD%20z%E1kon%20-%20EU
53608,78,1304632800,85,56,16,8,165,A,Novela%20z.%20-%20energetick%FD%20z%E1kon%20-%20EU
53609,78,1304632800,52,31,48,34,165,R,Novela%20z.%20-%20energetick%FD%20z%E1kon%20-%20EU
53610,78,1304632800,49,61,27,28,165,R,Novela%20z.%20-%20energetick%FD%20z%E1kon%20-%20EU
53611,78,1304632800,14,105,37,9,165,R,Novela%20z.%20-%20energetick%FD%20z%E1kon%20-%20EU
53612,78,1304632800,39,98,18,10,165,R,Novela%20z.%20-%20energetick%FD%20z%E1kon%20-%20EU
53613,78,1304632800,119,5,32,9,165,A,Novela%20z.%20-%20energetick%FD%20z%E1kon%20-%20EU
53614,78,1304632800,52,98,9,6,165,R,Novela%20z.%20-%20energetick%FD%20z%E1kon%20-%20EU
53615,78,1304632800,47,99,10,9,165,R,Novela%20z.%20-%20energetick%FD%20z%E1kon%20-%20EU
53616,78,1304632800,45,100,11,9,165,R,Novela%20z.%20-%20energetick%FD%20z%E1kon%20-%20EU
53617,78,1304632800,47,99,11,9,166,R,Novela%20z.%20-%20energetick%FD%20z%E1kon%20-%20EU
53618,78,1304632800,44,100,14,8,166,R,Novela%20z.%20-%20energetick%FD%20z%E1kon%20-%20EU
53619,78,1304632800,46,101,12,7,166,R,Novela%20z.%20-%20energetick%FD%20z%E1kon%20-%20EU
53620,78,1304632800,49,95,13,9,166,R,Novela%20z.%20-%20energetick%FD%20z%E1kon%20-%20EU
53621,78,1304632800,149,4,8,5,166,A,Novela%20z.%20-%20energetick%FD%20z%E1kon%20-%20EU
53622,78,1304632800,45,97,14,10,166,R,Novela%20z.%20-%20energetick%FD%20z%E1kon%20-%20EU
53623,78,1304632800,53,92,9,12,166,R,Novela%20z.%20-%20energetick%FD%20z%E1kon%20-%20EU
53624,78,1304632800,47,102,12,5,166,R,Novela%20z.%20-%20energetick%FD%20z%E1kon%20-%20EU
53625,78,1304632800,62,88,10,4,164,R,Novela%20z.%20-%20energetick%FD%20z%E1kon%20-%20EU
53626,78,1304632800,46,102,8,9,165,R,Novela%20z.%20-%20energetick%FD%20z%E1kon%20-%20EU
53627,78,1304632800,101,14,34,17,166,A,Novela%20z.%20-%20energetick%FD%20z%E1kon%20-%20EU
53628,78,1304632800,99,40,13,14,166,A,Novela%20z.%20-%20energetick%FD%20z%E1kon%20-%20EU
53629,82,1304632800,133,3,26,2,164,A,Novela%20z.%20o%20hornick%E9%20%u010Dinnosti
53630,82,1304632800,136,0,25,1,162,A,Novela%20z.%20o%20hornick%E9%20%u010Dinnosti
53631,82,1304632800,136,1,23,1,161,A,Novela%20z.%20o%20hornick%E9%20%u010Dinnosti
53632,82,1304632800,30,78,44,9,161,R,Novela%20z.%20o%20hornick%E9%20%u010Dinnosti
53633,82,1304632800,137,1,22,0,160,A,Novela%20z.%20o%20hornick%E9%20%u010Dinnosti
53634,82,1304632800,138,0,22,1,161,A,Novela%20z.%20o%20hornick%E9%20%u010Dinnosti
53635,74,1304632800,105,1,49,3,158,A,Novela%20devizov%E9ho%20z%E1kona%20-%20EU
53636,74,1304632800,105,27,27,0,159,A,Novela%20devizov%E9ho%20z%E1kona%20-%20EU
53637,75,1304632800,127,2,29,1,159,A,Novela%20z.%20o%20nakl%E1d%E1n%ED%20se%20surov%FDmi%20diamanty%20-%20EU
53638,76,1304632800,126,2,29,0,157,A,Novela%20z.%20o%20finan%u010Dn%EDm%20arbitrovi%20-%20EU
53639,76,1304632800,132,3,22,0,157,A,Novela%20z.%20o%20finan%u010Dn%EDm%20arbitrovi%20-%20EU
53640,76,1304632800,56,62,27,12,157,R,Novela%20z.%20o%20finan%u010Dn%EDm%20arbitrovi%20-%20EU
53641,76,1304632800,55,61,28,13,157,R,Novela%20z.%20o%20finan%u010Dn%EDm%20arbitrovi%20-%20EU
53642,76,1304632800,135,4,18,0,157,A,Novela%20z.%20o%20finan%u010Dn%EDm%20arbitrovi%20-%20EU
53643,76,1304632800,110,26,18,3,157,A,Novela%20z.%20o%20finan%u010Dn%EDm%20arbitrovi%20-%20EU
53644,81,1304632800,128,1,26,0,155,A,Novela%20z.%20o%20ochran%u011B%20ovzdu%u0161%ED%20-%20EU
53645,81,1304632800,83,21,40,11,155,A,Novela%20z.%20o%20ochran%u011B%20ovzdu%u0161%ED%20-%20EU
53646,81,1304632800,133,2,21,0,156,A,Novela%20z.%20o%20ochran%u011B%20ovzdu%u0161%ED%20-%20EU
53647,77,1304632800,125,1,27,1,154,A,Novela%20z.%20o%20opat%u0159en%EDch%20t%FDkaj%EDc%EDch%20se%20dovozu%20a%20v%FDvozu%20zbo%u017E%ED%20-%20EU
53648,80,1304632800,127,2,26,2,157,A,Novela%20z.%20o%20kolektivn%EDm%20investov%E1n%ED%20-%20EU
53649,80,1304632800,130,6,21,0,157,A,Novela%20z.%20o%20kolektivn%EDm%20investov%E1n%ED%20-%20EU
53650,80,1304632800,133,5,18,1,157,A,Novela%20z.%20o%20kolektivn%EDm%20investov%E1n%ED%20-%20EU
53651,80,1304632800,125,6,20,6,157,A,Novela%20z.%20o%20kolektivn%EDm%20investov%E1n%ED%20-%20EU
53652,80,1304632800,130,5,21,1,157,A,Novela%20z.%20o%20kolektivn%EDm%20investov%E1n%ED%20-%20EU
53653,83,1304632800,127,3,25,1,156,A,Novela%20z.%20o%20dani%20z%20nemovitost%ED
53654,83,1304632800,129,4,22,1,156,A,Novela%20z.%20o%20dani%20z%20nemovitost%ED
53655,84,1304632800,127,0,28,0,155,A,Vl.n.z.%20o%20z%E1kazu%20kazetov%E9%20munice
53656,112,1304632800,121,0,34,0,155,A,N%E1vrh%20zm%u011Bny%20rozpo%u010Dtu%20SFRB%20na%20rok%202011
53657,85,1304632800,115,2,33,4,154,A,Novela%20z.%20o%20advokacii
53658,85,1304632800,116,1,34,0,151,A,Novela%20z.%20o%20advokacii
53659,86,1304632800,111,2,37,1,151,A,Novela%20z.%20o%20trestn%EDm%20%u0159%EDzen%ED%20soudn%EDm%20%28trestn%ED%20%u0159%E1d%29
53660,86,1304632800,113,1,35,2,151,A,Novela%20z.%20o%20trestn%EDm%20%u0159%EDzen%ED%20soudn%EDm%20%28trestn%ED%20%u0159%E1d%29
53661,87,1304632800,116,1,31,1,149,A,Vl.n.z.o%20sou%u010Dinnosti%20pro%20%FA%u010Dely%20%u0159%EDzen%ED%20p%u0159ed%20mezin%E1rod.%20soudy
53662,87,1304632800,118,2,29,1,150,A,Vl.n.z.o%20sou%u010Dinnosti%20pro%20%FA%u010Dely%20%u0159%EDzen%ED%20p%u0159ed%20mezin%E1rod.%20soudy
53663,88,1304632800,117,2,31,2,152,A,Novela%20z.%20o%20trestn%EDm%20%u0159%EDzen%ED%20soudn%EDm%20%28trestn%ED%20%u0159%E1d%29
53664,90,1304632800,104,1,44,3,152,A,Novela%20z.%20o%20soudech%20a%20soudc%EDch
53665,90,1304632800,87,4,47,14,152,A,Novela%20z.%20o%20soudech%20a%20soudc%EDch
53666,90,1304632800,88,13,46,5,152,A,Novela%20z.%20o%20soudech%20a%20soudc%EDch
53667,0,1304978400,119,5,12,1,137,A,Po%u0159ad%20sch%u016Fze
53668,0,1304978400,126,1,11,3,141,A,Po%u0159ad%20sch%u016Fze
53669,0,1304978400,134,0,9,4,147,A,Po%u0159ad%20sch%u016Fze
53670,41,1304978400,128,0,27,0,155,A,Novela%20z.%20o%20v%FDkonu%20%FAstavn%ED%20v%FDchovy
53671,29,1304978400,115,1,43,0,159,A,Novela%20z.%20o%20Rejst%u0159%EDku%20trest%u016F%20-%20EU
53672,29,1304978400,77,26,43,13,159,R,Novela%20z.%20o%20Rejst%u0159%EDku%20trest%u016F%20-%20EU
53673,30,1304978400,120,1,38,0,159,A,N.z.o%20trestn%ED%20odpov%u011Bdnosti%20pr%E1v.%20osob%20a%20%u0159%EDzen%ED%20proti%20nim%20-%20EU
53674,30,1304978400,51,79,27,6,163,R,N.z.o%20trestn%ED%20odpov%u011Bdnosti%20pr%E1v.%20osob%20a%20%u0159%EDzen%ED%20proti%20nim%20-%20EU
53675,30,1304978400,148,0,15,0,163,A,N.z.o%20trestn%ED%20odpov%u011Bdnosti%20pr%E1v.%20osob%20a%20%u0159%EDzen%ED%20proti%20nim%20-%20EU
53676,31,1304978400,130,1,30,1,162,A,N.z.%20o%20zm%u011Bn%u011B%20z%E1kon%u016F%20v%20souvisl.s%20p%u0159ij.z%E1k.o%20tr.odpov%u011Bdnosti
53677,31,1304978400,134,1,26,1,162,A,N.z.%20o%20zm%u011Bn%u011B%20z%E1kon%u016F%20v%20souvisl.s%20p%u0159ij.z%E1k.o%20tr.odpov%u011Bdnosti
53678,33,1304978400,131,0,30,1,162,A,Novela%20z.%20-%20trestn%ED%20z%E1kon%EDk%20-%20EU
53679,36,1304978400,127,0,33,2,162,A,Novela%20obchodn%EDho%20z%E1kon%EDku%20-%20EU
53680,51,1304978400,116,0,46,0,162,A,Novela%20z.%20-%20soudn%ED%20%u0159%E1d%20spr%E1vn%ED
53681,53,1304978400,22,84,4,19,129,R,Novela%20z.%20o%20znalc%EDch%20a%20tlumo%u010Dn%EDc%EDch
53682,53,1304978400,124,0,5,1,130,A,Novela%20z.%20o%20znalc%EDch%20a%20tlumo%u010Dn%EDc%EDch
53683,50,1304978400,104,0,28,1,133,A,Novela%20z.%20o%20z%E1pisech%20vlastnick%FDch%20pr%E1v%20k%20nemovitostem
53684,43,1304978400,77,46,2,6,131,A,Novela%20z.%20o%20st%u0159etu%20z%E1jm%u016F
53685,44,1304978400,59,85,0,0,144,R,N.z.%20o%20zru%u0161en%ED%20z%E1kona%20o%20ve%u0159ej.%20nezis.%20%FAstav.%20zdrav.%20za%u0159%EDz.
53686,44,1304978400,141,2,2,0,145,A,N.z.%20o%20zru%u0161en%ED%20z%E1kona%20o%20ve%u0159ej.%20nezis.%20%FAstav.%20zdrav.%20za%u0159%EDz.
53687,0,1305064800,95,6,18,3,122,A,Po%u0159ad%20sch%u016Fze
53688,0,1305064800,110,1,12,0,123,A,Po%u0159ad%20sch%u016Fze
53689,0,1305064800,100,4,19,1,124,A,Po%u0159ad%20sch%u016Fze
53690,73,1305064800,8,83,30,8,129,R,Novela%20z.%20o%20urychlen%ED%20v%FDstavby%20dopravn%ED%20infrastruktury
53691,73,1305064800,117,2,11,2,132,A,Novela%20z.%20o%20urychlen%ED%20v%FDstavby%20dopravn%ED%20infrastruktury
53692,73,1305064800,117,1,12,2,132,A,Novela%20z.%20o%20urychlen%ED%20v%FDstavby%20dopravn%ED%20infrastruktury
53693,73,1305064800,91,6,21,14,132,A,Novela%20z.%20o%20urychlen%ED%20v%FDstavby%20dopravn%ED%20infrastruktury
53694,79,1305064800,62,11,44,15,132,R,Novela%20z.%20-%20z%E1kon%EDk%20pr%E1ce%20-%20EU
53695,79,1305064800,95,4,11,3,113,A,Novela%20z.%20-%20z%E1kon%EDk%20pr%E1ce%20-%20EU
53696,79,1305064800,66,15,24,11,116,A,Novela%20z.%20-%20z%E1kon%EDk%20pr%E1ce%20-%20EU
53697,79,1305064800,65,14,25,12,116,A,Novela%20z.%20-%20z%E1kon%EDk%20pr%E1ce%20-%20EU
53698,79,1305064800,68,18,23,10,119,A,Novela%20z.%20-%20z%E1kon%EDk%20pr%E1ce%20-%20EU
53699,89,1305064800,52,72,3,0,127,R,Novela%20z.%20o%20soudn%EDch%20poplatc%EDch
53700,89,1305064800,121,5,6,0,132,A,Novela%20z.%20o%20soudn%EDch%20poplatc%EDch
53701,89,1305064800,94,27,5,6,132,A,Novela%20z.%20o%20soudn%EDch%20poplatc%EDch
53702,89,1305064800,106,22,4,1,133,A,Novela%20z.%20o%20soudn%EDch%20poplatc%EDch
53703,89,1305064800,130,1,3,1,135,A,Novela%20z.%20o%20soudn%EDch%20poplatc%EDch
53704,89,1305064800,80,51,4,0,135,A,Novela%20z.%20o%20soudn%EDch%20poplatc%EDch
53705,91,1305064800,53,77,2,1,133,R,Novela%20z.%20o%20d%u016Fchodov%E9m%20poji%u0161t%u011Bn%ED
53706,91,1305064800,57,77,1,0,135,R,Novela%20z.%20o%20d%u016Fchodov%E9m%20poji%u0161t%u011Bn%ED
53707,91,1305064800,82,53,0,1,136,A,Novela%20z.%20o%20d%u016Fchodov%E9m%20poji%u0161t%u011Bn%ED
53708,0,1307397600,128,3,19,0,150,A,%20
53709,0,1307397600,173,1,8,1,183,A,Po%u0159ad%20sch%u016Fze
53710,0,1307397600,178,1,5,0,184,A,Po%u0159ad%20sch%u016Fze
53711,0,1307397600,181,1,2,0,184,A,Po%u0159ad%20sch%u016Fze
53712,0,1307397600,113,25,34,13,185,A,Po%u0159ad%20sch%u016Fze
53713,0,1307397600,176,4,5,1,186,A,Po%u0159ad%20sch%u016Fze
53714,0,1307397600,112,21,31,23,187,A,Po%u0159ad%20sch%u016Fze
53715,0,1307397600,143,8,30,7,188,A,Po%u0159ad%20sch%u016Fze
53716,0,1307397600,182,2,5,0,189,A,Po%u0159ad%20sch%u016Fze
53717,0,1307397600,113,68,3,6,190,A,Po%u0159ad%20sch%u016Fze
53718,0,1307397600,78,104,7,1,190,R,Po%u0159ad%20sch%u016Fze
53719,0,1307397600,36,123,14,17,190,R,Po%u0159ad%20sch%u016Fze
53720,0,1307397600,74,113,3,0,190,R,Po%u0159ad%20sch%u016Fze
53721,0,1307397600,74,111,4,1,190,R,Po%u0159ad%20sch%u016Fze
53722,0,1307397600,74,110,6,0,190,R,Po%u0159ad%20sch%u016Fze
53723,0,1307397600,72,106,12,0,190,R,Po%u0159ad%20sch%u016Fze
53724,0,1307397600,74,113,3,0,190,R,Po%u0159ad%20sch%u016Fze
53725,0,1307397600,75,86,12,17,190,R,Po%u0159ad%20sch%u016Fze
53726,0,1307397600,77,90,10,13,190,R,Po%u0159ad%20sch%u016Fze
53727,0,1307397600,114,71,2,3,190,A,Po%u0159ad%20sch%u016Fze
53728,0,1307397600,172,2,15,1,190,A,%20
53729,1,1307397600,141,1,39,6,187,A,Novela%20z.%20o%20ochran%u011B%20ovzdu%u0161%ED
53730,28,1307397600,156,2,28,0,186,A,Novela%20z.%20o%20ve%u0159ejn%FDch%20zak%E1zk%E1ch
53731,28,1307397600,100,42,36,6,184,A,Novela%20z.%20o%20ve%u0159ejn%FDch%20zak%E1zk%E1ch
53732,29,1307397600,72,98,17,0,187,R,Novela%20z.%20o%20stavebn%EDm%20spo%u0159en%ED%20a%20st%E1tn%ED%20podp.%20staveb.%20spo%u0159en%ED
53733,29,1307397600,165,3,19,0,187,A,Novela%20z.%20o%20stavebn%EDm%20spo%u0159en%ED%20a%20st%E1tn%ED%20podp.%20staveb.%20spo%u0159en%ED
53734,29,1307397600,100,70,15,2,187,A,Novela%20z.%20o%20stavebn%EDm%20spo%u0159en%ED%20a%20st%E1tn%ED%20podp.%20staveb.%20spo%u0159en%ED
53735,30,1307397600,71,105,11,0,187,R,Novela%20z.%20o%20dani%20z%20p%u0159idan%E9%20hodnoty%20-%20EU
53736,30,1307397600,175,2,11,0,188,A,Novela%20z.%20o%20dani%20z%20p%u0159idan%E9%20hodnoty%20-%20EU
53737,30,1307397600,106,69,13,0,188,A,Novela%20z.%20o%20dani%20z%20p%u0159idan%E9%20hodnoty%20-%20EU
53738,0,1307484000,93,32,10,13,148,A,Po%u0159ad%20sch%u016Fze
53739,0,1307484000,89,56,4,0,149,A,Po%u0159ad%20sch%u016Fze
53740,34,1307484000,70,87,3,1,161,R,Vl.n.z.%20-%20ob%u010Dansk%FD%20z%E1kon%EDk%20-%20EU
53741,34,1307484000,67,97,1,1,166,R,Vl.n.z.%20-%20ob%u010Dansk%FD%20z%E1kon%EDk%20-%20EU
53742,34,1307484000,68,96,4,0,168,R,Vl.n.z.%20-%20ob%u010Dansk%FD%20z%E1kon%EDk%20-%20EU
53743,34,1307484000,167,2,2,0,171,A,Vl.n.z.%20-%20ob%u010Dansk%FD%20z%E1kon%EDk%20-%20EU
53744,34,1307484000,172,0,1,0,173,A,Vl.n.z.%20-%20ob%u010Dansk%FD%20z%E1kon%EDk%20-%20EU
53745,99,1307484000,146,1,22,0,169,A,N%E1vrh%20na%20volbu%20%u010Dlen%u016F%20DR%20SFDI
53746,100,1307484000,143,1,25,0,169,A,N%E1vrh%20na%20volbu%20%u010Dlen%u016F%20DR%20SZIF
53747,102,1307484000,146,1,25,0,172,A,N%E1vrh%20na%20volbu%20%u010Dlen%u016F%20R%20%u010CRo
53748,103,1307484000,144,1,26,0,171,A,N%E1vrh%20na%20volbu%20%u010Dlen%u016F%20R%20%u010CT
53749,35,1307484000,103,2,61,1,167,A,Vl.n.z.%20o%20obchodn%EDch%20korporac%EDch%20-%20EU
53750,35,1307484000,55,86,32,0,173,R,Vl.n.z.%20o%20obchodn%EDch%20korporac%EDch%20-%20EU
53751,35,1307484000,143,1,29,1,174,A,Vl.n.z.%20o%20obchodn%EDch%20korporac%EDch%20-%20EU
53752,35,1307484000,146,1,27,0,174,A,Vl.n.z.%20o%20obchodn%EDch%20korporac%EDch%20-%20EU
53753,36,1307484000,117,0,55,0,172,A,Vl.n.z.%20o%20mezin%E1rodn%EDm%20pr%E1vu%20soukrom%E9m%20-%20EU
53754,36,1307484000,121,0,49,2,172,A,Vl.n.z.%20o%20mezin%E1rodn%EDm%20pr%E1vu%20soukrom%E9m%20-%20EU
53755,37,1307484000,105,0,64,2,171,A,Novela%20z.%20o%20p%u0159em%u011Bn%E1ch%20obchodn%EDch%20spole%u010Dnost%ED%20a%20dru%u017Estev%20-%20EU
53756,37,1307484000,116,0,56,0,172,A,Novela%20z.%20o%20p%u0159em%u011Bn%E1ch%20obchodn%EDch%20spole%u010Dnost%ED%20a%20dru%u017Estev%20-%20EU
53757,31,1307484000,49,97,1,1,148,R,Novela%20z.%20o%20pomoci%20v%20hmotn%E9%20nouzi
53758,31,1307484000,149,0,1,0,150,A,Novela%20z.%20o%20pomoci%20v%20hmotn%E9%20nouzi
53759,32,1307484000,53,91,0,0,144,R,Novela%20z.%20o%20zam%u011Bstnanosti
53760,32,1307484000,53,89,2,0,144,R,Novela%20z.%20o%20zam%u011Bstnanosti
53761,32,1307484000,143,0,1,0,144,A,Novela%20z.%20o%20zam%u011Bstnanosti
53762,33,1307484000,50,84,6,0,140,R,Vl.n.z.%20o%20poskytov%E1n%ED%20d%E1vek%20osob%E1m%20se%20zdravotn%EDm%20posti%u017Een%EDm
53763,33,1307484000,135,0,5,0,140,A,Vl.n.z.%20o%20poskytov%E1n%ED%20d%E1vek%20osob%E1m%20se%20zdravotn%EDm%20posti%u017Een%EDm
53764,0,1307570400,81,1,2,0,84,A,Po%u0159ad%20sch%u016Fze
53765,0,1307570400,82,0,2,1,85,A,Po%u0159ad%20sch%u016Fze
53766,0,1307570400,87,0,2,1,90,A,Po%u0159ad%20sch%u016Fze
53767,0,1307570400,70,4,10,5,89,A,Po%u0159ad%20sch%u016Fze
53768,0,1307570400,58,17,12,5,92,A,Po%u0159ad%20sch%u016Fze
53769,0,1307570400,88,0,3,1,92,A,Po%u0159ad%20sch%u016Fze
53770,113,1307570400,48,58,19,0,125,R,P%EDsemn%E1%20interpelace%20M.%20V%E1ni%20na%20P.%20Ne%u010Dase%20ve%20v%u011Bci%20st%E1tn%EDho%20rozpo%u010Dtu
53771,104,1307570400,103,0,30,0,133,A,Souhr.%20zpr%E1va%20o%20%u010Dinnosti%20ve%u0159ejn%E9ho%20ochr%E1nce%20pr%E1v%20za%20rok%202010
53772,57,1307570400,117,2,1,2,122,A,Sm%u011Brnice%20o%20spol.%20konsolid.%20z%E1kladu%20dan%u011B%20z%20p%u0159%EDjm%u016F%20pr%E1vn.%20osob
53773,57,1307570400,70,28,20,4,122,A,Sm%u011Brnice%20o%20spol.%20konsolid.%20z%E1kladu%20dan%u011B%20z%20p%u0159%EDjm%u016F%20pr%E1vn.%20osob
53774,57,1307570400,102,0,21,2,125,A,Sm%u011Brnice%20o%20spol.%20konsolid.%20z%E1kladu%20dan%u011B%20z%20p%u0159%EDjm%u016F%20pr%E1vn.%20osob
53775,57,1307570400,73,27,20,4,124,A,Sm%u011Brnice%20o%20spol.%20konsolid.%20z%E1kladu%20dan%u011B%20z%20p%u0159%EDjm%u016F%20pr%E1vn.%20osob
53776,57,1307570400,66,10,29,19,124,A,Sm%u011Brnice%20o%20spol.%20konsolid.%20z%E1kladu%20dan%u011B%20z%20p%u0159%EDjm%u016F%20pr%E1vn.%20osob
53777,57,1307570400,113,2,8,2,125,A,Sm%u011Brnice%20o%20spol.%20konsolid.%20z%E1kladu%20dan%u011B%20z%20p%u0159%EDjm%u016F%20pr%E1vn.%20osob
53778,69,1307570400,111,0,12,0,123,A,Doh.%20mezi%20st%E1ty%20EU%20a%20Gruzi%ED%20o%20spol.%20leteck%E9m%20prostoru
53779,70,1307570400,115,0,9,0,124,A,Evr.-st%u0159edomo%u0159.%20let.doh.mezi%20st%E1ty%20EU%20a%20Jord%E1nsk%FDm%20h%E1%u0161.kr%E1l.
53780,71,1307570400,114,0,11,0,125,A,Zm%u011Bny%20%DAml.%20Mezin%E1rodn%ED%20dru%u017Eicov%E9%20org.%20pro%20pohybliv%E9%20slu%u017Eby
53781,72,1307570400,113,0,13,0,126,A,P%u0159%EDstup%20%u010CR%20k%20revid.%20Prot.%20o%20Mez.dru%u017E.org.%20pro%20pohyb.%20slu%u017Eby
53782,0,1307656800,92,2,27,2,123,A,Po%u0159ad%20sch%u016Fze
53783,4,1307656800,28,98,18,14,158,R,N.z.%20o%20protikomunistick%E9m%20odboji
53784,4,1307656800,118,0,36,8,162,A,N.z.%20o%20protikomunistick%E9m%20odboji
53785,2,1307656800,52,87,3,1,143,R,Novela%20z.%20o%20ve%u0159ejn%E9m%20zdravotn%EDm%20poji%u0161t%u011Bn%ED%20-%20EU
53786,2,1307656800,52,90,1,0,143,R,Novela%20z.%20o%20ve%u0159ejn%E9m%20zdravotn%EDm%20poji%u0161t%u011Bn%ED%20-%20EU
53787,2,1307656800,74,38,0,0,112,A,Novela%20z.%20o%20ve%u0159ejn%E9m%20zdravotn%EDm%20poji%u0161t%u011Bn%ED%20-%20EU
53788,54,1307656800,76,38,0,6,120,A,Novela%20z.%20o%20rozpo%u010Dtov%E9m%20ur%u010Den%ED%20dan%ED
53789,0,1308002400,137,2,17,0,156,A,%20
53790,0,1308002400,158,8,10,2,178,A,Po%u0159ad%20sch%u016Fze
53791,0,1308002400,165,6,8,1,180,A,Po%u0159ad%20sch%u016Fze
53792,0,1308002400,154,12,10,4,180,A,Po%u0159ad%20sch%u016Fze
53793,0,1308002400,102,45,28,5,180,A,Po%u0159ad%20sch%u016Fze
53794,0,1308002400,105,25,32,18,180,A,Po%u0159ad%20sch%u016Fze
53795,0,1308002400,105,26,36,13,180,A,Po%u0159ad%20sch%u016Fze
53796,0,1308002400,103,27,37,14,181,A,Po%u0159ad%20sch%u016Fze
53797,0,1308002400,111,20,32,18,181,A,Po%u0159ad%20sch%u016Fze
53798,0,1308002400,165,2,11,3,181,A,Po%u0159ad%20sch%u016Fze
53799,125,1308002400,103,39,23,17,182,A,N%E1vrh%20na%20zkr%E1cen%ED%20lh%u016Fty%20k%20projedn%E1n%ED%20ST%20326
53800,48,1308002400,157,1,25,0,183,A,Novela%20z.%20o%20vzd%u011Bl%E1v%E1n%ED%20-%20%u0161kolsk%FD%20z%E1kon
53801,48,1308002400,80,61,37,5,183,R,Novela%20z.%20o%20vzd%u011Bl%E1v%E1n%ED%20-%20%u0161kolsk%FD%20z%E1kon
53802,55,1308002400,111,2,65,1,179,A,Novela%20z.%20-%20soudn%ED%20%u0159%E1d%20spr%E1vn%ED
53803,55,1308002400,86,55,39,0,180,R,Novela%20z.%20-%20soudn%ED%20%u0159%E1d%20spr%E1vn%ED
53804,55,1308002400,123,7,46,4,180,A,Novela%20z.%20-%20soudn%ED%20%u0159%E1d%20spr%E1vn%ED
53805,55,1308002400,88,55,2,0,145,A,Novela%20z.%20-%20soudn%ED%20%u0159%E1d%20spr%E1vn%ED
53806,53,1308002400,135,0,21,0,156,A,Novela%20z.%20o%20z%EDsk%E1v%E1n%ED%20zp%u016Fsob.%20k%20v%FDkonu%20zdrav.%20povol%E1n%ED
53807,53,1308002400,84,51,4,3,142,A,Novela%20z.%20o%20z%EDsk%E1v%E1n%ED%20zp%u016Fsob.%20k%20v%FDkonu%20zdrav.%20povol%E1n%ED
53808,19,1308002400,67,67,7,3,144,R,Novela%20z.%20o%20rodin%u011B
53809,41,1308002400,113,0,41,0,154,A,Novela%20z.%20o%20trestn%EDm%20%u0159%EDzen%ED%20soudn%EDm%20%28trestn%ED%20%u0159%E1d%29%20-%20EU
53810,43,1308002400,125,2,36,0,163,A,Novela%20z.%20o%20ekologick%E9m%20zem%u011Bd%u011Blstv%ED%20-%20EU
53811,43,1308002400,125,2,36,0,163,A,Novela%20z.%20o%20ekologick%E9m%20zem%u011Bd%u011Blstv%ED%20-%20EU
53812,45,1308002400,77,65,6,7,155,R,Novela%20z.%20o%20pomoci%20v%20hmotn%E9%20nouzi
53813,45,1308002400,150,2,6,0,158,A,Novela%20z.%20o%20pomoci%20v%20hmotn%E9%20nouzi
53814,45,1308002400,79,72,6,3,160,R,Novela%20z.%20o%20pomoci%20v%20hmotn%E9%20nouzi
53815,45,1308002400,139,10,10,1,160,A,Novela%20z.%20o%20pomoci%20v%20hmotn%E9%20nouzi
53816,45,1308002400,155,0,4,1,160,A,Novela%20z.%20o%20pomoci%20v%20hmotn%E9%20nouzi
53817,47,1308002400,44,70,33,13,160,R,Novela%20z.%20o%20pedagogick%FDch%20pracovn%EDc%EDch
53818,47,1308002400,142,0,22,0,164,A,Novela%20z.%20o%20pedagogick%FDch%20pracovn%EDc%EDch
53819,49,1308002400,140,1,20,0,161,A,Novela%20z.%20o%20platu%20st%E1tn%EDch%20z%E1stupc%u016F
53820,49,1308002400,127,4,29,2,162,A,Novela%20z.%20o%20platu%20st%E1tn%EDch%20z%E1stupc%u016F
53821,0,1308088800,116,5,27,5,153,A,Po%u0159ad%20sch%u016Fze
53822,0,1308088800,97,12,39,13,161,A,Po%u0159ad%20sch%u016Fze
53823,0,1308088800,92,16,45,10,163,A,Po%u0159ad%20sch%u016Fze
53824,15,1308088800,142,1,21,4,168,A,Novela%20z.%20o%20loteri%EDch
53825,74,1308088800,170,0,16,0,186,A,Novela%20z.%20o%20jednac%EDm%20%u0159%E1du%20PS
53826,74,1308088800,170,0,16,0,186,A,Novela%20z.%20o%20jednac%EDm%20%u0159%E1du%20PS
53827,74,1308088800,137,12,21,17,187,A,Novela%20z.%20o%20jednac%EDm%20%u0159%E1du%20PS
53828,74,1308088800,175,0,12,0,187,A,Novela%20z.%20o%20jednac%EDm%20%u0159%E1du%20PS
53829,74,1308088800,38,124,16,9,187,R,Novela%20z.%20o%20jednac%EDm%20%u0159%E1du%20PS
53830,74,1308088800,85,49,24,29,187,R,Novela%20z.%20o%20jednac%EDm%20%u0159%E1du%20PS
53831,74,1308088800,172,0,11,4,187,A,Novela%20z.%20o%20jednac%EDm%20%u0159%E1du%20PS
53832,75,1308088800,40,113,25,6,184,R,N.z.%20o%20protikomunistick%E9m%20odboji
53833,75,1308088800,100,24,38,21,183,A,N.z.%20o%20protikomunistick%E9m%20odboji
53834,75,1308088800,150,1,31,3,185,A,N.z.%20o%20protikomunistick%E9m%20odboji
53835,75,1308088800,144,0,34,7,185,A,N.z.%20o%20protikomunistick%E9m%20odboji
53836,75,1308088800,50,100,32,4,186,R,N.z.%20o%20protikomunistick%E9m%20odboji
53837,75,1308088800,48,100,31,6,185,R,N.z.%20o%20protikomunistick%E9m%20odboji
53838,75,1308088800,47,98,33,7,185,R,N.z.%20o%20protikomunistick%E9m%20odboji
53839,75,1308088800,47,100,33,5,185,R,N.z.%20o%20protikomunistick%E9m%20odboji
53840,75,1308088800,150,0,30,5,185,A,N.z.%20o%20protikomunistick%E9m%20odboji
53841,75,1308088800,46,103,31,5,185,R,N.z.%20o%20protikomunistick%E9m%20odboji
53842,75,1308088800,46,101,34,4,185,R,N.z.%20o%20protikomunistick%E9m%20odboji
53843,75,1308088800,149,1,30,5,185,A,N.z.%20o%20protikomunistick%E9m%20odboji
53844,75,1308088800,132,33,2,8,175,A,N.z.%20o%20protikomunistick%E9m%20odboji
53845,39,1308088800,134,0,41,0,175,A,Novela%20z.%20o%20odpadech
53846,39,1308088800,132,1,35,6,174,A,Novela%20z.%20o%20odpadech
53847,40,1308088800,135,1,39,0,175,A,Novela%20z.%20o%20obchodov%E1n%ED%20s%20ohro%u017Een%FDmi%20druhy%20-%20EU
53848,80,1308088800,113,0,61,1,175,A,Novela%20z.%20o%20n%E1mo%u0159n%ED%20plavb%u011B%20-%20EU
53849,81,1308088800,132,1,38,3,174,A,Novela%20z.%20o%20silni%u010Dn%EDm%20provozu%20-%20EU
53850,81,1308088800,139,0,31,3,173,A,Novela%20z.%20o%20silni%u010Dn%EDm%20provozu%20-%20EU
53851,81,1308088800,128,13,29,4,174,A,Novela%20z.%20o%20silni%u010Dn%EDm%20provozu%20-%20EU
53852,81,1308088800,25,108,32,9,174,R,Novela%20z.%20o%20silni%u010Dn%EDm%20provozu%20-%20EU
53853,81,1308088800,60,84,29,1,174,R,Novela%20z.%20o%20silni%u010Dn%EDm%20provozu%20-%20EU
53854,81,1308088800,83,23,46,22,174,R,Novela%20z.%20o%20silni%u010Dn%EDm%20provozu%20-%20EU
53855,81,1308088800,83,28,45,18,174,R,Novela%20z.%20o%20silni%u010Dn%EDm%20provozu%20-%20EU
53856,81,1308088800,57,43,55,19,174,R,Novela%20z.%20o%20silni%u010Dn%EDm%20provozu%20-%20EU
53857,81,1308088800,135,2,29,9,175,A,Novela%20z.%20o%20silni%u010Dn%EDm%20provozu%20-%20EU
53858,97,1308088800,121,1,43,8,173,A,Novela%20z.%20o%20%FAprav%u011B%20vlastnick%FDch%20vztah%u016F%20k%20p%u016Fd%u011B
53859,97,1308088800,136,10,27,1,174,A,Novela%20z.%20o%20%FAprav%u011B%20vlastnick%FDch%20vztah%u016F%20k%20p%u016Fd%u011B
53860,42,1308088800,111,0,57,0,168,A,Novela%20z.%20o%20elektronick%FDch%20komunikac%EDch%20-%20EU
53861,42,1308088800,110,0,59,0,169,A,Novela%20z.%20o%20elektronick%FDch%20komunikac%EDch%20-%20EU
53862,56,1308088800,115,0,1,0,116,A,Rozhodnut%ED%20Evropsk%E9%20rady%20-%20zm%u011Bna%20%u010Dl.%20136%20Sml.%20o%20fungov%E1n%ED%20EU
53863,56,1308088800,113,2,2,1,118,A,Rozhodnut%ED%20Evropsk%E9%20rady%20-%20zm%u011Bna%20%u010Dl.%20136%20Sml.%20o%20fungov%E1n%ED%20EU
53864,66,1308088800,117,0,7,2,126,A,R%E1mcov%E1%20doh.%20o%20partnerstv%ED%20mezi%20st%E1ty%20ES%20a%20Indon%E9skou%20rep.
53865,58,1308088800,117,1,16,1,135,A,Doh.%20o%20partnerstv%ED
53866,38,1308088800,121,0,22,3,146,A,Novela%20z.%20o%20%u010Dinnosti%20instituc%ED%20zam%u011Bstnaneck%E9ho%20penzijn%EDho%20poji%u0161t%u011Bn%ED%20-
53867,38,1308088800,114,0,30,3,147,A,Novela%20z.%20o%20%u010Dinnosti%20instituc%ED%20zam%u011Bstnaneck%E9ho%20penzijn%EDho%20poji%u0161t%u011Bn%ED%20-
53868,38,1308088800,125,0,24,0,149,A,Novela%20z.%20o%20%u010Dinnosti%20instituc%ED%20zam%u011Bstnaneck%E9ho%20penzijn%EDho%20poji%u0161t%u011Bn%ED%20-
53869,111,1308088800,103,7,33,4,147,A,N%E1vrh%20zv%FD%u0161.%20st%u0159edn%u011Bdob.%20v%FDdajov%FDch%20r%E1mc%u016F%20na%20l%E9ta%202012%20a%202013
53870,0,1308175200,66,0,13,2,81,A,Po%u0159ad%20sch%u016Fze
53871,0,1308175200,77,3,6,1,87,A,Po%u0159ad%20sch%u016Fze
53872,113,1308175200,52,18,4,3,77,A,P%EDsemn%E1%20interpelace%20Z.%20Boh%E1%u010De%20na%20R.%20%u0160merdu%20ve%20v%u011Bci%20situace%20ohledn%u011B%20kl%ED
53873,0,1308175200,83,1,27,1,112,A,%20
53874,0,1308175200,77,32,8,3,120,A,Po%u0159ad%20sch%u016Fze
53875,1,1308175200,88,0,2,2,92,A,Inf.%20o%20podez%u0159en%ED%20z%20pl%FDtv%E1n%ED%20prodst%u0159edk%u016F%20p%u0159i%20p%u0159edsednictv%ED%20v%20R%20EU
53876,1,1308175200,78,0,0,0,78,A,Inf.%20o%20podez%u0159en%ED%20z%20pl%FDtv%E1n%ED%20prodst%u0159edk%u016F%20p%u0159i%20p%u0159edsednictv%ED%20v%20R%20EU
53877,1,1308175200,29,56,12,25,122,R,Inf.%20o%20podez%u0159en%ED%20z%20pl%FDtv%E1n%ED%20prodst%u0159edk%u016F%20p%u0159i%20p%u0159edsednictv%ED%20v%20R%20EU
53878,0,1308261600,113,5,9,1,128,A,Po%u0159ad%20sch%u016Fze
53879,0,1308261600,88,8,29,7,132,A,Po%u0159ad%20sch%u016Fze
53880,0,1308261600,130,0,4,1,135,A,Po%u0159ad%20sch%u016Fze
53881,0,1308261600,124,3,8,3,138,A,Po%u0159ad%20sch%u016Fze
53882,0,1308261600,118,5,12,4,139,A,%20
53883,44,1308261600,104,0,57,1,162,A,Vl.n.z.%20o%20podporovan%FDch%20zdroj%EDch%20energie%20-%20EU
53884,44,1308261600,42,97,20,8,167,R,Vl.n.z.%20o%20podporovan%FDch%20zdroj%EDch%20energie%20-%20EU
53885,44,1308261600,38,103,19,7,167,R,Vl.n.z.%20o%20podporovan%FDch%20zdroj%EDch%20energie%20-%20EU
53886,44,1308261600,154,4,11,0,169,A,Vl.n.z.%20o%20podporovan%FDch%20zdroj%EDch%20energie%20-%20EU
53887,44,1308261600,147,7,15,0,169,A,Vl.n.z.%20o%20podporovan%FDch%20zdroj%EDch%20energie%20-%20EU
53888,44,1308261600,102,32,19,16,169,A,Vl.n.z.%20o%20podporovan%FDch%20zdroj%EDch%20energie%20-%20EU
53889,44,1308261600,30,70,45,24,169,R,Vl.n.z.%20o%20podporovan%FDch%20zdroj%EDch%20energie%20-%20EU
53890,50,1308261600,119,1,45,0,165,A,Novela%20z.%20-%20%DAstava%20%u010Cesk%E9%20republiky
53891,50,1308261600,126,4,32,3,165,A,Novela%20z.%20-%20%DAstava%20%u010Cesk%E9%20republiky
53892,51,1308261600,126,0,40,0,166,A,Novela%20z.%20o%20Nejvy%u0161%u0161%EDm%20kontroln%EDm%20%FA%u0159adu
53893,51,1308261600,105,15,41,5,166,A,Novela%20z.%20o%20Nejvy%u0161%u0161%EDm%20kontroln%EDm%20%FA%u0159adu
53894,51,1308261600,112,6,44,4,166,A,Novela%20z.%20o%20Nejvy%u0161%u0161%EDm%20kontroln%EDm%20%FA%u0159adu
53895,52,1308261600,112,0,50,0,162,A,Novela%20z.%20o%20rozhod%u010D%EDm%20%u0159%EDzen%ED
53896,63,1308261600,115,0,43,0,158,A,Doh.%20mezi%20vl.%20%u010CR%20a%20vl.%20Gruzie%20o%20leteck%FDch%20slu%u017Eb%E1ch
53897,64,1308261600,108,0,51,0,159,A,Evropsk%E1%20doh.%20o%20mezin%E1rodn%ED%20p%u0159eprav%u011B%20nebezpe%u010Dn%FDch%20v%u011Bc%ED
53898,115,1308261600,94,0,62,4,160,A,N%E1vrh%20PS%20na%20prop%u016Fj%u010Den%ED%20nebo%20ud%u011Blen%ED%20st%E1tn%EDch%20vyznamen%E1n%ED
53899,116,1308261600,105,0,4,0,109,A,Na%u0159%EDzen%ED%20Rady%20o%20elektronick%E9m%20zve%u0159ej.%20%DA%u0159edn%EDho%20v%u011Bstn%EDku%20EU
53900,59,1308261600,105,0,20,0,125,A,Doh.%20o%20voln%E9m%20obchodu%20mezi%20st%E1ty%20EU%20a%20Korejskou%20rep.
53901,60,1308261600,114,0,14,0,128,A,Z%E1kladn%ED%20dokumenty%20Mezin%E1rodn%ED%20telekom.%20unie%20a%20jejich%20zm%u011Bny
53902,61,1308261600,111,0,20,0,131,A,Meziamerick%E1%20%FAml.%20o%20v%FDkonu%20trestn%EDch%20rozsudk%u016F%20v%20cizin%u011B
53903,62,1308261600,107,0,25,0,132,A,Sml.%20mezi%20%u010CR%20a%20%u0160v%FDc.%20spol.%20radou%20o%20ochr.%20utaj.%20informac%ED
53904,65,1308261600,114,0,22,0,136,A,Charta%20Mezin%E1rodn%EDho%20energetick%E9ho%20f%F3ra
53905,67,1308261600,113,1,24,0,138,A,Doh.%20mezi%20%u010CR%20a%20Sr%EDlanskou%20dem.%20soc.%20rep.%20o%20podpo%u0159e%20investic
53906,68,1308261600,117,1,26,0,144,A,Sml.%20mezi%20%u010CR%20a%20Lucem.%20velkov%E9v.%20o%20v%FDm.%20a%20ochr.%20utaj.%20infom.
53907,105,1308261600,62,41,33,6,142,R,N%E1vrhy%20zdravotn%u011B%20pojistn%FDch%20pl%E1n%u016F%20na%20rok%202011
53908,105,1308261600,104,4,7,4,119,A,N%E1vrhy%20zdravotn%u011B%20pojistn%FDch%20pl%E1n%u016F%20na%20rok%202011
53909,105,1308261600,68,41,2,9,120,A,N%E1vrhy%20zdravotn%u011B%20pojistn%FDch%20pl%E1n%u016F%20na%20rok%202011
53910,106,1308261600,110,0,7,1,118,A,V%FDro%u010Dn%ED%20zpr%E1va%20o%20%u010Dinnosti%20%u010Cesk%E9%20televize%20v%20roce%202010
53911,107,1308261600,88,2,22,9,121,A,V%FDro%u010Dn%ED%20zpr%E1va%20Rady%20%u010Cesk%E9ho%20rozhlasu%20za%20rok%202010
53912,108,1308261600,112,0,13,0,125,A,Ro%u010Dn%ED%20%FA%u010Detn%ED%20z%E1v%u011Brka%20a%20v%FDro%u010Dn%ED%20zpr%E1va%20SFRB%20za%20rok%202010
53913,109,1308261600,75,45,3,8,131,A,N%E1vrh%20st%E1tn%EDho%20z%E1v%u011Bre%u010Dn%E9ho%20%FA%u010Dtu%20%u010CR%20za%20rok%202010
53914,110,1308261600,112,4,10,6,132,A,Zpr%E1va%20o%20%u010Dinnosti%20a%20hospoda%u0159en%ED%20ER%DA%20za%20rok%202010
53915,0,1308607200,80,30,24,4,138,A,Po%u0159ad%20sch%u016Fze
53916,0,1308607200,80,49,15,3,147,A,Po%u0159ad%20sch%u016Fze
53917,0,1308607200,90,22,32,7,151,A,Po%u0159ad%20sch%u016Fze
53918,0,1308607200,91,21,31,12,155,A,Po%u0159ad%20sch%u016Fze
53919,0,1308607200,116,8,30,4,158,A,Po%u0159ad%20sch%u016Fze
53920,73,1308607200,77,103,2,0,182,R,Novela%20z.%20o%20ve%u0159ejn%E9m%20zdravotn%EDm%20poji%u0161t%u011Bn%ED%20-%20EU
53921,73,1308607200,79,77,14,12,182,R,Novela%20z.%20o%20ve%u0159ejn%E9m%20zdravotn%EDm%20poji%u0161t%u011Bn%ED%20-%20EU
53922,73,1308607200,78,93,8,3,182,R,Novela%20z.%20o%20ve%u0159ejn%E9m%20zdravotn%EDm%20poji%u0161t%u011Bn%ED%20-%20EU
53923,73,1308607200,103,49,19,9,180,A,Novela%20z.%20o%20ve%u0159ejn%E9m%20zdravotn%EDm%20poji%u0161t%u011Bn%ED%20-%20EU
53924,73,1308607200,75,103,2,0,180,R,Novela%20z.%20o%20ve%u0159ejn%E9m%20zdravotn%EDm%20poji%u0161t%u011Bn%ED%20-%20EU
53925,73,1308607200,74,96,4,6,180,R,Novela%20z.%20o%20ve%u0159ejn%E9m%20zdravotn%EDm%20poji%u0161t%u011Bn%ED%20-%20EU
53926,73,1308607200,74,102,4,0,180,R,Novela%20z.%20o%20ve%u0159ejn%E9m%20zdravotn%EDm%20poji%u0161t%u011Bn%ED%20-%20EU
53927,73,1308607200,75,103,2,0,180,R,Novela%20z.%20o%20ve%u0159ejn%E9m%20zdravotn%EDm%20poji%u0161t%u011Bn%ED%20-%20EU
53928,73,1308607200,77,92,6,5,180,R,Novela%20z.%20o%20ve%u0159ejn%E9m%20zdravotn%EDm%20poji%u0161t%u011Bn%ED%20-%20EU
53929,73,1308607200,134,34,5,7,180,A,Novela%20z.%20o%20ve%u0159ejn%E9m%20zdravotn%EDm%20poji%u0161t%u011Bn%ED%20-%20EU
53930,73,1308607200,104,75,1,0,180,A,Novela%20z.%20o%20ve%u0159ejn%E9m%20zdravotn%EDm%20poji%u0161t%u011Bn%ED%20-%20EU
53931,73,1308607200,105,73,2,0,180,A,Novela%20z.%20o%20ve%u0159ejn%E9m%20zdravotn%EDm%20poji%u0161t%u011Bn%ED%20-%20EU
53932,0,1308607200,98,0,75,2,175,A,%20
53933,117,1308607200,34,112,29,5,180,R,Novela%20z.%20o%20soudn%EDch%20poplatc%EDch
53934,117,1308607200,142,10,26,2,180,A,Novela%20z.%20o%20soudn%EDch%20poplatc%EDch
53935,117,1308607200,105,69,7,0,181,A,Novela%20z.%20o%20soudn%EDch%20poplatc%EDch
53936,118,1308607200,43,119,2,4,168,R,Novela%20z.%20o%20dani%20z%20nemovitost%ED
53937,118,1308607200,157,5,5,2,169,A,Novela%20z.%20o%20dani%20z%20nemovitost%ED
53938,119,1308607200,156,1,1,0,158,A,Vl.n.z.%20o%20z%E1kazu%20kazetov%E9%20munice
53939,120,1308607200,49,94,9,12,164,R,Novela%20z.%20o%20advokacii
53940,120,1308607200,164,2,1,0,167,A,Novela%20z.%20o%20advokacii
53941,121,1308607200,164,1,4,1,170,A,Novela%20z.%20o%20opat%u0159en%EDch%20t%FDkaj%EDc%EDch%20se%20dovozu%20a%20v%FDvozu%20zbo%u017E%ED%20-%20EU
53942,122,1308607200,11,107,32,21,171,R,Novela%20z.%20o%20soudech%20a%20soudc%EDch
53943,122,1308607200,143,1,23,4,171,A,Novela%20z.%20o%20soudech%20a%20soudc%EDch
53944,123,1308607200,141,6,23,1,171,A,Novela%20z.%20o%20d%u016Fchodov%E9m%20poji%u0161t%u011Bn%ED
53945,123,1308607200,70,103,1,0,174,R,Novela%20z.%20o%20d%u016Fchodov%E9m%20poji%u0161t%u011Bn%ED
53946,123,1308607200,105,71,0,0,176,A,Novela%20z.%20o%20d%u016Fchodov%E9m%20poji%u0161t%u011Bn%ED
53947,124,1308607200,159,0,14,1,174,A,Novela%20z.%20o%20ochran%u011B%20ovzdu%u0161%ED%20-%20EU
53948,25,1308607200,104,1,63,3,171,A,Novela%20z.%20o%20%u010Cesk%E9%20televizi
53949,76,1308607200,128,2,40,0,170,A,Novela%20z.%20o%20rostlinol%E9ka%u0159sk%E9%20p%E9%u010Di%20-%20EU
53950,76,1308607200,132,0,1,0,133,A,Novela%20z.%20o%20rostlinol%E9ka%u0159sk%E9%20p%E9%u010Di%20-%20EU
53951,76,1308607200,133,0,3,1,137,A,Novela%20z.%20o%20rostlinol%E9ka%u0159sk%E9%20p%E9%u010Di%20-%20EU
53952,76,1308607200,136,0,1,2,139,A,Novela%20z.%20o%20rostlinol%E9ka%u0159sk%E9%20p%E9%u010Di%20-%20EU
53953,76,1308607200,139,0,1,1,141,A,Novela%20z.%20o%20rostlinol%E9ka%u0159sk%E9%20p%E9%u010Di%20-%20EU
53954,77,1308607200,127,2,13,1,143,A,Novela%20z.%20o%20vinohradnictv%ED%20a%20vina%u0159stv%ED%20-%20EU
53955,77,1308607200,133,0,10,1,144,A,Novela%20z.%20o%20vinohradnictv%ED%20a%20vina%u0159stv%ED%20-%20EU
53956,77,1308607200,133,0,10,1,144,A,Novela%20z.%20o%20vinohradnictv%ED%20a%20vina%u0159stv%ED%20-%20EU
53957,78,1308607200,114,2,29,1,146,A,Novela%20z.%20o%20Celn%ED%20spr%E1v%u011B%20%u010CR%20-%20EU
53958,78,1308607200,129,1,17,0,147,A,Novela%20z.%20o%20Celn%ED%20spr%E1v%u011B%20%u010CR%20-%20EU
53959,79,1308607200,133,0,11,2,146,A,Novela%20z.%20-%20veterin%E1rn%ED%20z%E1kon%20-%20EU
53960,79,1308607200,54,79,13,0,146,R,Novela%20z.%20-%20veterin%E1rn%ED%20z%E1kon%20-%20EU
53961,79,1308607200,51,81,13,2,147,R,Novela%20z.%20-%20veterin%E1rn%ED%20z%E1kon%20-%20EU
53962,79,1308607200,55,80,12,1,148,R,Novela%20z.%20-%20veterin%E1rn%ED%20z%E1kon%20-%20EU
53963,79,1308607200,140,0,10,0,150,A,Novela%20z.%20-%20veterin%E1rn%ED%20z%E1kon%20-%20EU
53964,79,1308607200,136,0,12,2,150,A,Novela%20z.%20-%20veterin%E1rn%ED%20z%E1kon%20-%20EU
53965,82,1308607200,129,1,16,1,147,A,Novela%20z.%20-%20atomov%FD%20z%E1kon%20-%20EU
53966,82,1308607200,130,1,16,0,147,A,Novela%20z.%20-%20atomov%FD%20z%E1kon%20-%20EU
53967,83,1308607200,122,0,25,1,148,A,Novela%20z.%20-%20atomov%FD%20z%E1kon
53968,83,1308607200,126,2,20,1,149,A,Novela%20z.%20-%20atomov%FD%20z%E1kon
53969,83,1308607200,127,1,21,0,149,A,Novela%20z.%20-%20atomov%FD%20z%E1kon
53970,84,1308607200,125,0,24,0,149,A,Novela%20z.%20o%20zahrani%u010Dn%EDm%20obchodu%20s%20vojensk%FDm%20materi%E1lem%20-%20EU
53971,84,1308607200,126,1,22,0,149,A,Novela%20z.%20o%20zahrani%u010Dn%EDm%20obchodu%20s%20vojensk%FDm%20materi%E1lem%20-%20EU
53972,85,1308607200,135,1,2,0,138,A,Novela%20z.%20o%20hospoda%u0159en%ED%20energi%ED%20-%20EU
53973,85,1308607200,129,3,6,1,139,A,Novela%20z.%20o%20hospoda%u0159en%ED%20energi%ED%20-%20EU
53974,85,1308607200,137,1,3,1,142,A,Novela%20z.%20o%20hospoda%u0159en%ED%20energi%ED%20-%20EU
53975,85,1308607200,137,1,3,1,142,A,Novela%20z.%20o%20hospoda%u0159en%ED%20energi%ED%20-%20EU
53976,85,1308607200,91,31,10,11,143,A,Novela%20z.%20o%20hospoda%u0159en%ED%20energi%ED%20-%20EU
53977,85,1308607200,113,6,22,5,146,A,Novela%20z.%20o%20hospoda%u0159en%ED%20energi%ED%20-%20EU
53978,85,1308607200,105,32,4,6,147,A,Novela%20z.%20o%20hospoda%u0159en%ED%20energi%ED%20-%20EU
53979,85,1308607200,119,3,20,6,148,A,Novela%20z.%20o%20hospoda%u0159en%ED%20energi%ED%20-%20EU
53980,91,1308607200,135,1,10,0,146,A,Novela%20z.%20o%20komoditn%EDch%20burz%E1ch
53981,91,1308607200,134,1,10,0,145,A,Novela%20z.%20o%20komoditn%EDch%20burz%E1ch
53982,101,1308607200,115,4,28,0,147,A,N%E1vrh%20PS%20na%20jmenov%E1n%ED%20%u010Dlena%20RRTV
53983,86,1308607200,158,2,8,0,168,A,Novela%20z.%20o%20loteri%EDch
53984,86,1308607200,42,96,27,4,169,R,Novela%20z.%20o%20loteri%EDch
53985,86,1308607200,83,24,31,31,169,R,Novela%20z.%20o%20loteri%EDch
53986,86,1308607200,149,0,11,1,161,A,Novela%20z.%20o%20loteri%EDch
53987,86,1308607200,116,18,24,5,163,A,Novela%20z.%20o%20loteri%EDch
53988,86,1308607200,19,95,26,23,163,R,Novela%20z.%20o%20loteri%EDch
53989,86,1308607200,138,1,21,3,163,A,Novela%20z.%20o%20loteri%EDch
53990,86,1308607200,19,54,44,47,164,R,Novela%20z.%20o%20loteri%EDch
53991,86,1308607200,0,26,134,4,164,R,Novela%20z.%20o%20loteri%EDch
53992,86,1308607200,1,105,41,17,164,R,Novela%20z.%20o%20loteri%EDch
53993,86,1308607200,1,100,47,16,164,R,Novela%20z.%20o%20loteri%EDch
53994,86,1308607200,22,71,42,29,164,R,Novela%20z.%20o%20loteri%EDch
53995,86,1308607200,135,19,7,3,164,A,Novela%20z.%20o%20loteri%EDch
53996,86,1308607200,144,17,2,1,164,A,Novela%20z.%20o%20loteri%EDch
53997,86,1308607200,19,63,35,47,164,R,Novela%20z.%20o%20loteri%EDch
53998,86,1308607200,118,18,22,6,164,A,Novela%20z.%20o%20loteri%EDch
53999,86,1308607200,138,18,4,4,164,A,Novela%20z.%20o%20loteri%EDch
54000,87,1308607200,81,25,44,6,156,A,Novela%20z.%20o%20loteri%EDch
54001,89,1308607200,41,70,41,2,154,R,Novela%20z.%20o%20podpo%u0159e%20region%E1ln%EDho%20rozvoje
54002,89,1308607200,115,0,3,4,122,A,Novela%20z.%20o%20podpo%u0159e%20region%E1ln%EDho%20rozvoje
54003,90,1308607200,23,87,14,4,128,R,Novela%20z.%20o%20rodin%u011B
54004,90,1308607200,70,56,8,1,135,A,Novela%20z.%20o%20rodin%u011B
54005,90,1308607200,82,3,38,12,135,A,Novela%20z.%20o%20rodin%u011B
54006,90,1308607200,124,0,13,1,138,A,Novela%20z.%20o%20rodin%u011B
54007,90,1308607200,107,13,18,2,140,A,Novela%20z.%20o%20rodin%u011B
54008,90,1308607200,67,57,11,1,136,R,Novela%20z.%20o%20rodin%u011B
54009,90,1308607200,77,35,18,11,141,A,Novela%20z.%20o%20rodin%u011B
54010,92,1308607200,106,13,22,1,142,A,Novela%20z.%20o%20St%E1tn%EDm%20zem%u011Bd.%20interven%u010Dn%EDm%20fondu
54011,93,1308607200,112,1,27,1,141,A,Novela%20z.%20o%20inf.%20syst%E9mech%20ve%u0159.%20spr%E1vy%20a%20o%20elektron.%20%FAkonech
54012,93,1308607200,96,1,42,2,141,A,Novela%20z.%20o%20inf.%20syst%E9mech%20ve%u0159.%20spr%E1vy%20a%20o%20elektron.%20%FAkonech
54013,93,1308607200,5,84,17,6,112,R,Novela%20z.%20o%20inf.%20syst%E9mech%20ve%u0159.%20spr%E1vy%20a%20o%20elektron.%20%FAkonech
54014,93,1308607200,95,0,20,5,120,A,Novela%20z.%20o%20inf.%20syst%E9mech%20ve%u0159.%20spr%E1vy%20a%20o%20elektron.%20%FAkonech
54015,93,1308607200,97,1,19,5,122,A,Novela%20z.%20o%20inf.%20syst%E9mech%20ve%u0159.%20spr%E1vy%20a%20o%20elektron.%20%FAkonech
54016,94,1308607200,107,2,9,10,128,A,Novela%20z.%20o%20soudnictv%ED%20ve%20v%u011Bcech%20ml%E1de%u017Ee
54017,94,1308607200,118,1,5,6,130,A,Novela%20z.%20o%20soudnictv%ED%20ve%20v%u011Bcech%20ml%E1de%u017Ee
54018,95,1308607200,122,0,7,1,130,A,Novela%20z.%20o%20ochran%u011B%20utaj.%20informac%ED%20a%20o%20bezpe%u010Dnostn%ED%20zp%u016Fsob.
54019,95,1308607200,119,2,7,2,130,A,Novela%20z.%20o%20ochran%u011B%20utaj.%20informac%ED%20a%20o%20bezpe%u010Dnostn%ED%20zp%u016Fsob.
54020,98,1308607200,125,1,5,0,131,A,Novela%20z.%20o%20kraj%EDch%20%28krajsk%E9%20z%u0159%EDzen%ED%29
54021,98,1308607200,123,0,9,0,132,A,Novela%20z.%20o%20kraj%EDch%20%28krajsk%E9%20z%u0159%EDzen%ED%29
54022,112,1308607200,126,1,5,0,132,A,V%FDro%u010Dn%ED%20zpr%E1va%20%u010Cesk%E9ho%20telekomunika%u010Dn%EDho%20%FA%u0159adu%20za%20rok%202010
54023,0,1308607200,110,10,9,1,130,A,%20
54024,0,1310421600,98,1,14,0,113,A,%20
54025,0,1310421600,74,41,29,5,149,R,Po%u0159ad%20sch%u016Fze
54026,0,1310421600,98,31,27,5,161,A,Po%u0159ad%20sch%u016Fze
54027,0,1310421600,87,61,13,3,164,A,Po%u0159ad%20sch%u016Fze
54028,0,1310421600,105,77,5,0,187,A,Po%u0159ad%20sch%u016Fze
54029,1,1310421600,71,107,9,0,187,R,Vl.n.z.%20o%20zdravotn%EDch%20slu%u017Eb%E1ch%20-%20EU
54030,1,1310421600,175,0,9,2,186,A,Vl.n.z.%20o%20zdravotn%EDch%20slu%u017Eb%E1ch%20-%20EU
54031,1,1310421600,84,70,18,15,187,R,Vl.n.z.%20o%20zdravotn%EDch%20slu%u017Eb%E1ch%20-%20EU
54032,1,1310421600,107,70,9,1,187,A,Vl.n.z.%20o%20zdravotn%EDch%20slu%u017Eb%E1ch%20-%20EU
54033,2,1310421600,176,0,12,0,188,A,Vl.n.z.%20o%20zdravotnick%E9%20z%E1chrann%E9%20slu%u017Eb%u011B
54034,2,1310421600,92,56,23,17,188,R,Vl.n.z.%20o%20zdravotnick%E9%20z%E1chrann%E9%20slu%u017Eb%u011B
54035,2,1310421600,105,69,12,3,189,A,Vl.n.z.%20o%20zdravotnick%E9%20z%E1chrann%E9%20slu%u017Eb%u011B
54036,3,1310421600,63,95,22,1,181,R,Vl.n.z.%20o%20specifick%FDch%20zdravotn%EDch%20slu%u017Eb%E1ch%20-%20EU
54037,3,1310421600,164,1,17,0,182,A,Vl.n.z.%20o%20specifick%FDch%20zdravotn%EDch%20slu%u017Eb%E1ch%20-%20EU
54038,3,1310421600,95,69,17,1,182,A,Vl.n.z.%20o%20specifick%FDch%20zdravotn%EDch%20slu%u017Eb%E1ch%20-%20EU
54039,4,1310421600,63,88,30,0,181,R,Vl.n.z.v%20souvislosti%20s%20p%u0159ijet%EDm%20z%E1kon%u016F%20o%20zdrav.%20slu%u017Eb%E1ch
54040,4,1310421600,145,5,1,2,153,A,Vl.n.z.v%20souvislosti%20s%20p%u0159ijet%EDm%20z%E1kon%u016F%20o%20zdrav.%20slu%u017Eb%E1ch
54041,4,1310421600,90,63,0,1,154,A,Vl.n.z.v%20souvislosti%20s%20p%u0159ijet%EDm%20z%E1kon%u016F%20o%20zdrav.%20slu%u017Eb%E1ch
54042,5,1310421600,67,101,0,0,168,R,Novela%20z.%20o%20ve%u0159ejn%E9m%20zdravotn%EDm%20poji%u0161t%u011Bn%ED
54043,5,1310421600,168,1,1,2,172,A,Novela%20z.%20o%20ve%u0159ejn%E9m%20zdravotn%EDm%20poji%u0161t%u011Bn%ED
54044,5,1310421600,102,67,1,1,171,A,Novela%20z.%20o%20ve%u0159ejn%E9m%20zdravotn%EDm%20poji%u0161t%u011Bn%ED
54045,6,1310421600,58,97,2,0,157,R,Novela%20z.%20-%20z%E1kon%EDk%20pr%E1ce%20-%20EU
54046,6,1310421600,153,1,0,3,157,A,Novela%20z.%20-%20z%E1kon%EDk%20pr%E1ce%20-%20EU
54047,6,1310421600,84,42,10,20,156,A,Novela%20z.%20-%20z%E1kon%EDk%20pr%E1ce%20-%20EU
54048,6,1310421600,96,59,0,2,157,A,Novela%20z.%20-%20z%E1kon%EDk%20pr%E1ce%20-%20EU
54049,0,1310508000,62,31,14,5,112,A,%20
54050,7,1310508000,94,17,32,7,150,A,Vl.n.z.%20o%20d%u016Fchodov%E9m%20spo%u0159en%ED%20-%20EU
54051,0,1310508000,97,49,5,0,151,A,%20
54052,7,1310508000,63,97,1,1,162,R,Vl.n.z.%20o%20d%u016Fchodov%E9m%20spo%u0159en%ED%20-%20EU
54053,7,1310508000,66,96,1,1,164,R,Vl.n.z.%20o%20d%u016Fchodov%E9m%20spo%u0159en%ED%20-%20EU
54054,7,1310508000,164,0,1,0,165,A,Vl.n.z.%20o%20d%u016Fchodov%E9m%20spo%u0159en%ED%20-%20EU
54055,7,1310508000,145,10,3,7,165,A,Vl.n.z.%20o%20d%u016Fchodov%E9m%20spo%u0159en%ED%20-%20EU
54056,7,1310508000,97,67,1,1,166,A,Vl.n.z.%20o%20d%u016Fchodov%E9m%20spo%u0159en%ED%20-%20EU
54057,8,1310508000,66,98,1,1,166,R,Vl.n.z.%20o%20dopl%u0148kov%E9m%20penzijn%EDm%20spo%u0159en%ED%20-%20EU
54058,8,1310508000,67,98,0,1,166,R,Vl.n.z.%20o%20dopl%u0148kov%E9m%20penzijn%EDm%20spo%u0159en%ED%20-%20EU
54059,8,1310508000,164,1,0,0,165,A,Vl.n.z.%20o%20dopl%u0148kov%E9m%20penzijn%EDm%20spo%u0159en%ED%20-%20EU
54060,8,1310508000,139,18,2,7,166,A,Vl.n.z.%20o%20dopl%u0148kov%E9m%20penzijn%EDm%20spo%u0159en%ED%20-%20EU
54061,8,1310508000,98,67,0,1,166,A,Vl.n.z.%20o%20dopl%u0148kov%E9m%20penzijn%EDm%20spo%u0159en%ED%20-%20EU
54062,9,1310508000,67,98,1,0,166,R,Vl.n.z.%20v%20souvislosti%20s%20p%u0159ij.%20z.%20o%20d%u016Fch.%20a%20pen.%20spo%u0159en%ED%20-%20EU
54063,9,1310508000,67,95,3,1,166,R,Vl.n.z.%20v%20souvislosti%20s%20p%u0159ij.%20z.%20o%20d%u016Fch.%20a%20pen.%20spo%u0159en%ED%20-%20EU
54064,9,1310508000,165,0,1,0,166,A,Vl.n.z.%20v%20souvislosti%20s%20p%u0159ij.%20z.%20o%20d%u016Fch.%20a%20pen.%20spo%u0159en%ED%20-%20EU
54065,9,1310508000,132,24,4,6,166,A,Vl.n.z.%20v%20souvislosti%20s%20p%u0159ij.%20z.%20o%20d%u016Fch.%20a%20pen.%20spo%u0159en%ED%20-%20EU
54066,9,1310508000,96,69,1,1,167,A,Vl.n.z.%20v%20souvislosti%20s%20p%u0159ij.%20z.%20o%20d%u016Fch.%20a%20pen.%20spo%u0159en%ED%20-%20EU
54067,10,1310508000,26,92,5,20,143,R,Vl.n.z.%20o%20Gener%E1ln%ED%20inspekci%20bezpe%u010Dnostn%EDch%20sbor%u016F
54068,10,1310508000,141,0,3,0,144,A,Vl.n.z.%20o%20Gener%E1ln%ED%20inspekci%20bezpe%u010Dnostn%EDch%20sbor%u016F
54069,10,1310508000,90,52,0,2,144,A,Vl.n.z.%20o%20Gener%E1ln%ED%20inspekci%20bezpe%u010Dnostn%EDch%20sbor%u016F
54070,0,1310508000,90,49,9,2,150,A,%20
54071,11,1310508000,148,2,2,1,153,A,Novela%20z.%20-%20%u0161kolsk%FD%20z%E1kon
54072,11,1310508000,117,26,4,6,153,A,Novela%20z.%20-%20%u0161kolsk%FD%20z%E1kon
54073,12,1310508000,8,8,131,1,148,R,Novela%20z.%20o%20%u010Cesk%E9%20televizi
54074,12,1310508000,37,91,8,12,148,R,Novela%20z.%20o%20%u010Cesk%E9%20televizi
54075,12,1310508000,144,0,5,0,149,A,Novela%20z.%20o%20%u010Cesk%E9%20televizi
54076,12,1310508000,91,36,9,13,149,A,Novela%20z.%20o%20%u010Cesk%E9%20televizi
54077,12,1310508000,93,26,17,13,149,A,Novela%20z.%20o%20%u010Cesk%E9%20televizi
54078,12,1310508000,116,14,9,9,148,A,Novela%20z.%20o%20%u010Cesk%E9%20televizi
54079,12,1310508000,92,36,10,10,148,A,Novela%20z.%20o%20%u010Cesk%E9%20televizi
54080,13,1310508000,127,0,20,0,147,A,Novela%20z.%20-%20soudn%ED%20%u0159%E1d%20spr%E1vn%ED
54081,13,1310508000,66,51,22,7,146,R,Novela%20z.%20-%20soudn%ED%20%u0159%E1d%20spr%E1vn%ED
54082,13,1310508000,107,9,16,15,147,A,Novela%20z.%20-%20soudn%ED%20%u0159%E1d%20spr%E1vn%ED
54083,14,1310508000,136,0,9,0,145,A,Novela%20z.%20o%20ve%u0159ejn%FDch%20zak%E1zk%E1ch%20-%20EU
54084,14,1310508000,34,83,28,2,147,R,Novela%20z.%20o%20ve%u0159ejn%FDch%20zak%E1zk%E1ch%20-%20EU
54085,14,1310508000,137,1,8,1,147,A,Novela%20z.%20o%20ve%u0159ejn%FDch%20zak%E1zk%E1ch%20-%20EU
54086,14,1310508000,132,2,11,2,147,A,Novela%20z.%20o%20ve%u0159ejn%FDch%20zak%E1zk%E1ch%20-%20EU
54087,15,1310508000,137,0,1,0,138,A,Novela%20z.%20o%20odpadech
54088,15,1310508000,116,1,20,3,140,A,Novela%20z.%20o%20odpadech
54089,16,1310508000,116,3,18,3,140,A,Novela%20z.%20o%20loteri%EDch
54090,0,1314655200,99,0,20,1,120,A,%20
54091,0,1314655200,76,98,7,5,186,R,Po%u0159ad%20sch%u016Fze
54092,0,1314655200,77,80,15,14,186,R,Po%u0159ad%20sch%u016Fze
54093,0,1314655200,76,86,13,11,186,R,Po%u0159ad%20sch%u016Fze
54094,0,1314655200,76,92,7,11,186,R,Po%u0159ad%20sch%u016Fze
54095,0,1314655200,75,82,9,20,186,R,Po%u0159ad%20sch%u016Fze
54096,0,1314655200,109,31,24,23,187,A,Po%u0159ad%20sch%u016Fze
54097,0,1314655200,109,45,25,8,187,A,Po%u0159ad%20sch%u016Fze
54098,0,1314655200,114,1,16,0,131,A,%20
54099,0,1314655200,103,66,1,5,175,A,Po%u0159ad%20sch%u016Fze
54100,1,1314655200,177,3,1,0,181,A,%u017D.%20o%20vysloven%ED%20souhlasu%20PS%20k%20trestn%EDmu%20st%EDh%E1n%ED%20poslanc%u016F
54101,0,1314655200,89,55,8,2,154,A,%20
54102,1,1314655200,136,3,1,4,144,A,Novela%20z.%20-%20%u0161kolsk%FD%20z%E1kon
54103,2,1314655200,69,40,36,2,147,R,Vl.n.z.%20v%20souvislosti%20s%20%FAsporn%FDmi%20opat%u0159en%EDmi%20v%20p%u016Fsob.%20MPSV
54104,2,1314655200,104,19,27,5,155,A,Vl.n.z.%20v%20souvislosti%20s%20%FAsporn%FDmi%20opat%u0159en%EDmi%20v%20p%u016Fsob.%20MPSV
54105,2,1314655200,90,49,2,1,142,A,Vl.n.z.%20v%20souvislosti%20s%20%FAsporn%FDmi%20opat%u0159en%EDmi%20v%20p%u016Fsob.%20MPSV
54106,3,1314655200,86,45,4,3,138,A,Novela%20z.%20o%20dani%20z%20p%u0159idan%E9%20hodnoty%20-%20EU
54107,4,1314655200,86,46,2,1,135,A,Novela%20z.%20o%20stavebn%EDm%20spo%u0159en%ED%20a%20st%E1tn%ED%20podp.%20staveb.%20spo%u0159en%ED
54108,5,1314655200,78,50,2,0,130,A,Vl.n.z.%20o%20zdravotn%EDch%20slu%u017Eb%E1ch%20-%20EU
54109,6,1314655200,94,51,16,1,162,A,Vl.n.z.%20o%20zdravotnick%E9%20z%E1chrann%E9%20slu%u017Eb%u011B
54110,7,1314655200,83,40,4,1,128,A,Vl.n.z.%20o%20specifick%FDch%20zdravotn%EDch%20slu%u017Eb%E1ch%20-%20EU
54111,8,1314655200,92,44,0,0,136,A,Vl.n.z.v%20souvislosti%20s%20p%u0159ijet%EDm%20z%E1kon%u016F%20o%20zdrav.%20slu%u017Eb%E1ch
54112,9,1314655200,85,55,11,0,151,A,Novela%20z.%20o%20ve%u0159ejn%E9m%20zdravotn%EDm%20poji%u0161t%u011Bn%ED
54113,10,1314655200,78,48,1,0,127,A,Vl.n.z.%20o%20Gener%E1ln%ED%20inspekci%20bezpe%u010Dnostn%EDch%20sbor%u016F
54114,11,1314655200,77,53,0,0,130,A,Novela%20z.%20-%20z%E1kon%EDk%20pr%E1ce%20-%20EU
54115,12,1314655200,78,25,25,2,130,A,Vl.n.z.%20o%20d%u016Fchodov%E9m%20spo%u0159en%ED%20-%20EU
54116,12,1314655200,84,53,11,0,148,A,Vl.n.z.%20o%20d%u016Fchodov%E9m%20spo%u0159en%ED%20-%20EU
54117,13,1314655200,89,50,10,0,149,A,Vl.n.z.%20o%20dopl%u0148kov%E9m%20penzijn%EDm%20spo%u0159en%ED%20-%20EU
54118,14,1314655200,88,49,2,0,139,A,Vl.n.z.%20v%20souvislosti%20s%20p%u0159ij.%20z.%20o%20d%u016Fch.%20a%20pen.%20spo%u0159en%ED%20-%20EU
54119,0,1314828000,74,49,5,0,128,A,Po%u0159ad%20sch%u016Fze
54120,18,1314828000,117,1,36,0,154,A,Novela%20z.%20o%20Pozemkov%E9m%20fondu%20%u010CR
54121,18,1314828000,77,33,41,3,154,R,Novela%20z.%20o%20Pozemkov%E9m%20fondu%20%u010CR
54122,18,1314828000,92,23,9,3,127,A,Novela%20z.%20o%20Pozemkov%E9m%20fondu%20%u010CR
54123,18,1314828000,85,38,4,3,130,A,Novela%20z.%20o%20Pozemkov%E9m%20fondu%20%u010CR
54124,19,1314828000,115,1,18,0,134,A,Novela%20z.%20o%20nemocensk%E9m%20poji%u0161t%u011Bn%ED
54125,19,1314828000,21,10,102,0,133,R,Novela%20z.%20o%20nemocensk%E9m%20poji%u0161t%u011Bn%ED
54126,19,1314828000,69,46,5,1,121,A,Novela%20z.%20o%20nemocensk%E9m%20poji%u0161t%u011Bn%ED
54127,20,1314828000,96,1,30,0,127,A,Novela%20z.%20o%20zam%u011Bstnanosti%20-%20EU
54128,20,1314828000,62,36,3,4,105,A,Novela%20z.%20o%20zam%u011Bstnanosti%20-%20EU
54129,21,1314828000,99,2,26,0,127,A,Vl.n.z.%20o%20Finan%u010Dn%ED%20spr%E1v%u011B%20%u010Cesk%E9%20republiky
54130,22,1314828000,97,0,28,2,127,A,Vl.n.z.%20v%20souvislosti%20s%20p%u0159ijet%EDm%20z%E1kona%20o%20Finan%u010Dn%ED%20spr%E1v%u011B%20%u010CR
54131,23,1314828000,109,1,21,1,132,A,Vl.n.z.%20o%20Celn%ED%20spr%E1v%u011B%20%u010Cesk%E9%20republiky%20-%20EU
54132,24,1314828000,114,1,16,1,132,A,Vl.n.z.%20v%20souvislosti%20s%20p%u0159ijet%EDm%20z%E1kona%20o%20Celn%ED%20spr%E1v%u011B%20%u010CR
54133,25,1314828000,106,4,23,0,133,A,Novela%20z.%20o%20slu%u017Eb%u011B%20st%E1tn%EDch%20zam%u011Bstnanc%u016F
54134,25,1314828000,62,43,23,5,133,R,Novela%20z.%20o%20slu%u017Eb%u011B%20st%E1tn%EDch%20zam%u011Bstnanc%u016F
54135,25,1314828000,23,14,73,1,111,R,Novela%20z.%20o%20slu%u017Eb%u011B%20st%E1tn%EDch%20zam%u011Bstnanc%u016F
54136,25,1314828000,83,24,7,2,116,A,Novela%20z.%20o%20slu%u017Eb%u011B%20st%E1tn%EDch%20zam%u011Bstnanc%u016F
54137,25,1314828000,65,48,4,3,120,A,Novela%20z.%20o%20slu%u017Eb%u011B%20st%E1tn%EDch%20zam%u011Bstnanc%u016F
54138,0,1314914400,77,29,19,6,131,A,Po%u0159ad%20sch%u016Fze
54139,12,1314914400,95,62,6,3,166,A,Novela%20z.%20-%20trestn%ED%20z%E1kon%EDk%20-%20EU
54140,26,1314914400,100,50,10,2,162,A,Novela%20z.%20-%20%u0161kolsk%FD%20z%E1kon
54141,26,1314914400,162,0,2,0,164,A,Novela%20z.%20-%20%u0161kolsk%FD%20z%E1kon
54142,26,1314914400,82,52,19,15,168,R,Novela%20z.%20-%20%u0161kolsk%FD%20z%E1kon
54143,27,1314914400,141,16,11,3,171,A,Vl.n.z.%20v%20souvislosti%20s%20%FAsporn%FDmi%20opat%u0159en%EDmi%20v%20p%u016Fsob.%20MPSV
54144,27,1314914400,67,102,0,0,169,R,Vl.n.z.%20v%20souvislosti%20s%20%FAsporn%FDmi%20opat%u0159en%EDmi%20v%20p%u016Fsob.%20MPSV
54145,27,1314914400,125,38,3,4,170,A,Vl.n.z.%20v%20souvislosti%20s%20%FAsporn%FDmi%20opat%u0159en%EDmi%20v%20p%u016Fsob.%20MPSV
54146,27,1314914400,101,70,0,0,171,A,Vl.n.z.%20v%20souvislosti%20s%20%FAsporn%FDmi%20opat%u0159en%EDmi%20v%20p%u016Fsob.%20MPSV
54147,27,1314914400,83,86,2,0,171,R,Vl.n.z.%20v%20souvislosti%20s%20%FAsporn%FDmi%20opat%u0159en%EDmi%20v%20p%u016Fsob.%20MPSV
54148,27,1314914400,124,13,19,14,170,A,Vl.n.z.%20v%20souvislosti%20s%20%FAsporn%FDmi%20opat%u0159en%EDmi%20v%20p%u016Fsob.%20MPSV
54149,27,1314914400,98,70,2,0,170,A,Vl.n.z.%20v%20souvislosti%20s%20%FAsporn%FDmi%20opat%u0159en%EDmi%20v%20p%u016Fsob.%20MPSV
54150,27,1314914400,101,70,0,0,171,A,Vl.n.z.%20v%20souvislosti%20s%20%FAsporn%FDmi%20opat%u0159en%EDmi%20v%20p%u016Fsob.%20MPSV
54151,28,1314914400,134,16,7,3,160,A,Novela%20z.%20o%20dani%20z%20p%u0159idan%E9%20hodnoty%20-%20EU
54152,28,1314914400,115,39,8,4,166,A,Novela%20z.%20o%20dani%20z%20p%u0159idan%E9%20hodnoty%20-%20EU
54153,28,1314914400,99,52,11,4,166,A,Novela%20z.%20o%20dani%20z%20p%u0159idan%E9%20hodnoty%20-%20EU
54154,28,1314914400,66,99,2,0,167,R,Novela%20z.%20o%20dani%20z%20p%u0159idan%E9%20hodnoty%20-%20EU
54155,28,1314914400,68,99,0,0,167,R,Novela%20z.%20o%20dani%20z%20p%u0159idan%E9%20hodnoty%20-%20EU
54156,28,1314914400,71,82,11,3,167,R,Novela%20z.%20o%20dani%20z%20p%u0159idan%E9%20hodnoty%20-%20EU
54157,28,1314914400,99,68,0,0,167,A,Novela%20z.%20o%20dani%20z%20p%u0159idan%E9%20hodnoty%20-%20EU
54158,29,1314914400,63,94,6,0,163,R,Novela%20z.%20o%20stavebn%EDm%20spo%u0159en%ED%20a%20st%E1tn%ED%20podp.%20staveb.%20spo%u0159en%ED
54159,29,1314914400,95,62,6,0,163,A,Novela%20z.%20o%20stavebn%EDm%20spo%u0159en%ED%20a%20st%E1tn%ED%20podp.%20staveb.%20spo%u0159en%ED
54160,0,1315260000,118,3,15,0,136,A,Po%u0159ad%20sch%u016Fze
54161,0,1315260000,79,39,18,6,142,A,Po%u0159ad%20sch%u016Fze
54162,0,1315260000,80,52,8,8,148,A,Po%u0159ad%20sch%u016Fze
54163,0,1315260000,88,58,10,1,157,A,Po%u0159ad%20sch%u016Fze
54164,0,1315260000,144,1,14,0,159,A,%20
54165,2,1315260000,7,3,164,1,175,R,Novela%20z.%20o%20ochran%u011B%20ovzdu%u0161%ED
54166,2,1315260000,110,26,22,12,170,A,Novela%20z.%20o%20ochran%u011B%20ovzdu%u0161%ED
54167,3,1315260000,103,68,5,1,177,A,Novela%20z.%20o%20ve%u0159ejn%E9m%20zdravotn%EDm%20poji%u0161t%u011Bn%ED%20-%20EU
54168,4,1315260000,137,24,14,2,177,A,Novela%20z.%20o%20%u010Cesk%E9%20televizi
54169,5,1315260000,152,18,8,1,179,A,Novela%20z.%20o%20loteri%EDch
54170,6,1315260000,85,69,9,9,172,R,Novela%20z.%20o%20rodin%u011B
54171,6,1315260000,88,51,16,17,172,R,Novela%20z.%20o%20rodin%u011B
54172,7,1315260000,156,0,1,1,158,A,Novela%20z.%20o%20soudnictv%ED%20ve%20v%u011Bcech%20ml%E1de%u017Ee
54173,8,1315260000,40,91,35,8,174,R,Novela%20z.%20-%20veterin%E1rn%ED%20z%E1kon%20-%20EU
54174,8,1315260000,146,16,6,6,174,A,Novela%20z.%20-%20veterin%E1rn%ED%20z%E1kon%20-%20EU
54175,10,1315260000,125,2,39,2,168,A,Novela%20z.%20-%20soudn%ED%20%u0159%E1d%20spr%E1vn%ED
54176,11,1315260000,87,17,23,34,161,A,Novela%20z.%20o%20hospoda%u0159en%ED%20energi%ED%20-%20EU
54177,13,1315260000,152,0,12,1,165,A,Novela%20z.%20-%20trestn%ED%20z%E1kon%EDk%20-%20EU
54178,13,1315260000,46,85,29,5,165,R,Novela%20z.%20-%20trestn%ED%20z%E1kon%EDk%20-%20EU
54179,13,1315260000,66,80,13,6,165,R,Novela%20z.%20-%20trestn%ED%20z%E1kon%EDk%20-%20EU
54180,13,1315260000,108,38,15,4,165,A,Novela%20z.%20-%20trestn%ED%20z%E1kon%EDk%20-%20EU
54181,13,1315260000,115,29,12,9,165,A,Novela%20z.%20-%20trestn%ED%20z%E1kon%EDk%20-%20EU
54182,14,1315260000,150,0,14,0,164,A,N%E1vrh%20na%20zm%u011Bny%20ve%20slo%u017Een%ED%20org%E1n%u016F%20Poslaneck%E9%20sn%u011Bmovny
54183,14,1315260000,145,6,12,2,165,A,N%E1vrh%20na%20zm%u011Bny%20ve%20slo%u017Een%ED%20org%E1n%u016F%20Poslaneck%E9%20sn%u011Bmovny
54184,9,1315260000,77,43,26,11,157,R,Novela%20z.%20o%20silni%u010Dn%EDm%20provozu%20-%20EU
54185,9,1315260000,152,2,2,3,159,A,Novela%20z.%20o%20silni%u010Dn%EDm%20provozu%20-%20EU
54186,9,1315260000,75,48,24,8,155,R,Novela%20z.%20o%20silni%u010Dn%EDm%20provozu%20-%20EU
54187,9,1315260000,106,24,8,19,157,A,Novela%20z.%20o%20silni%u010Dn%EDm%20provozu%20-%20EU
54188,0,1315260000,127,12,15,5,159,A,%20
54189,30,1315346400,65,103,4,0,172,R,Vl.n.z.%20o%20zdravotn%EDch%20slu%u017Eb%E1ch%20-%20EU
54190,30,1315346400,125,35,9,6,175,A,Vl.n.z.%20o%20zdravotn%EDch%20slu%u017Eb%E1ch%20-%20EU
54191,30,1315346400,171,1,3,0,175,A,Vl.n.z.%20o%20zdravotn%EDch%20slu%u017Eb%E1ch%20-%20EU
54192,30,1315346400,172,1,1,1,175,A,Vl.n.z.%20o%20zdravotn%EDch%20slu%u017Eb%E1ch%20-%20EU
54193,30,1315346400,106,45,22,2,175,A,Vl.n.z.%20o%20zdravotn%EDch%20slu%u017Eb%E1ch%20-%20EU
54194,30,1315346400,67,107,1,0,175,R,Vl.n.z.%20o%20zdravotn%EDch%20slu%u017Eb%E1ch%20-%20EU
54195,30,1315346400,108,47,17,3,175,A,Vl.n.z.%20o%20zdravotn%EDch%20slu%u017Eb%E1ch%20-%20EU
54196,30,1315346400,46,107,18,4,175,R,Vl.n.z.%20o%20zdravotn%EDch%20slu%u017Eb%E1ch%20-%20EU
54197,30,1315346400,67,108,0,0,175,R,Vl.n.z.%20o%20zdravotn%EDch%20slu%u017Eb%E1ch%20-%20EU
54198,30,1315346400,0,109,34,32,175,R,Vl.n.z.%20o%20zdravotn%EDch%20slu%u017Eb%E1ch%20-%20EU
54199,30,1315346400,92,46,31,6,175,A,Vl.n.z.%20o%20zdravotn%EDch%20slu%u017Eb%E1ch%20-%20EU
54200,30,1315346400,3,112,29,31,175,R,Vl.n.z.%20o%20zdravotn%EDch%20slu%u017Eb%E1ch%20-%20EU
54201,30,1315346400,101,43,28,3,175,A,Vl.n.z.%20o%20zdravotn%EDch%20slu%u017Eb%E1ch%20-%20EU
54202,30,1315346400,108,4,32,31,175,A,Vl.n.z.%20o%20zdravotn%EDch%20slu%u017Eb%E1ch%20-%20EU
54203,30,1315346400,114,10,25,26,175,A,Vl.n.z.%20o%20zdravotn%EDch%20slu%u017Eb%E1ch%20-%20EU
54204,30,1315346400,146,1,24,4,175,A,Vl.n.z.%20o%20zdravotn%EDch%20slu%u017Eb%E1ch%20-%20EU
54205,30,1315346400,45,104,22,4,175,R,Vl.n.z.%20o%20zdravotn%EDch%20slu%u017Eb%E1ch%20-%20EU
54206,30,1315346400,43,107,22,3,175,R,Vl.n.z.%20o%20zdravotn%EDch%20slu%u017Eb%E1ch%20-%20EU
54207,30,1315346400,43,107,22,3,175,R,Vl.n.z.%20o%20zdravotn%EDch%20slu%u017Eb%E1ch%20-%20EU
54208,30,1315346400,109,15,26,25,175,A,Vl.n.z.%20o%20zdravotn%EDch%20slu%u017Eb%E1ch%20-%20EU
54209,30,1315346400,108,67,0,0,175,A,Vl.n.z.%20o%20zdravotn%EDch%20slu%u017Eb%E1ch%20-%20EU
54210,0,1315346400,96,54,21,0,171,A,%20
54211,31,1315346400,142,8,6,1,157,A,Vl.n.z.%20o%20zdravotnick%E9%20z%E1chrann%E9%20slu%u017Eb%u011B
54212,31,1315346400,92,39,23,4,158,A,Vl.n.z.%20o%20zdravotnick%E9%20z%E1chrann%E9%20slu%u017Eb%u011B
54213,31,1315346400,93,38,22,4,157,A,Vl.n.z.%20o%20zdravotnick%E9%20z%E1chrann%E9%20slu%u017Eb%u011B
54214,32,1315346400,129,23,7,1,160,A,Vl.n.z.%20o%20specifick%FDch%20zdravotn%EDch%20slu%u017Eb%E1ch%20-%20EU
54215,32,1315346400,57,98,5,0,160,R,Vl.n.z.%20o%20specifick%FDch%20zdravotn%EDch%20slu%u017Eb%E1ch%20-%20EU
54216,32,1315346400,94,40,21,5,160,A,Vl.n.z.%20o%20specifick%FDch%20zdravotn%EDch%20slu%u017Eb%E1ch%20-%20EU
54217,32,1315346400,93,37,25,5,160,A,Vl.n.z.%20o%20specifick%FDch%20zdravotn%EDch%20slu%u017Eb%E1ch%20-%20EU
54218,32,1315346400,94,25,24,17,160,A,Vl.n.z.%20o%20specifick%FDch%20zdravotn%EDch%20slu%u017Eb%E1ch%20-%20EU
54219,32,1315346400,38,40,62,19,159,R,Vl.n.z.%20o%20specifick%FDch%20zdravotn%EDch%20slu%u017Eb%E1ch%20-%20EU
54220,32,1315346400,99,18,32,11,160,A,Vl.n.z.%20o%20specifick%FDch%20zdravotn%EDch%20slu%u017Eb%E1ch%20-%20EU
54221,32,1315346400,153,1,6,0,160,A,Vl.n.z.%20o%20specifick%FDch%20zdravotn%EDch%20slu%u017Eb%E1ch%20-%20EU
54222,32,1315346400,106,15,26,13,160,A,Vl.n.z.%20o%20specifick%FDch%20zdravotn%EDch%20slu%u017Eb%E1ch%20-%20EU
54223,32,1315346400,24,109,13,14,160,R,Vl.n.z.%20o%20specifick%FDch%20zdravotn%EDch%20slu%u017Eb%E1ch%20-%20EU
54224,32,1315346400,3,110,32,16,161,R,Vl.n.z.%20o%20specifick%FDch%20zdravotn%EDch%20slu%u017Eb%E1ch%20-%20EU
54225,32,1315346400,92,64,3,1,160,A,Vl.n.z.%20o%20specifick%FDch%20zdravotn%EDch%20slu%u017Eb%E1ch%20-%20EU
54226,33,1315346400,135,6,12,3,156,A,Vl.n.z.v%20souvislosti%20s%20p%u0159ijet%EDm%20z%E1kon%u016F%20o%20zdrav.%20slu%u017Eb%E1ch
54227,33,1315346400,57,91,10,0,158,R,Vl.n.z.v%20souvislosti%20s%20p%u0159ijet%EDm%20z%E1kon%u016F%20o%20zdrav.%20slu%u017Eb%E1ch
54228,33,1315346400,90,37,28,3,158,A,Vl.n.z.v%20souvislosti%20s%20p%u0159ijet%EDm%20z%E1kon%u016F%20o%20zdrav.%20slu%u017Eb%E1ch
54229,33,1315346400,89,34,28,7,158,A,Vl.n.z.v%20souvislosti%20s%20p%u0159ijet%EDm%20z%E1kon%u016F%20o%20zdrav.%20slu%u017Eb%E1ch
54230,33,1315346400,92,59,7,0,158,A,Vl.n.z.v%20souvislosti%20s%20p%u0159ijet%EDm%20z%E1kon%u016F%20o%20zdrav.%20slu%u017Eb%E1ch
54231,34,1315346400,129,11,15,5,160,A,Novela%20z.%20o%20ve%u0159ejn%E9m%20zdravotn%EDm%20poji%u0161t%u011Bn%ED
54232,34,1315346400,59,95,8,0,162,R,Novela%20z.%20o%20ve%u0159ejn%E9m%20zdravotn%EDm%20poji%u0161t%u011Bn%ED
54233,34,1315346400,94,18,36,14,162,A,Novela%20z.%20o%20ve%u0159ejn%E9m%20zdravotn%EDm%20poji%u0161t%u011Bn%ED
54234,34,1315346400,92,18,38,14,162,A,Novela%20z.%20o%20ve%u0159ejn%E9m%20zdravotn%EDm%20poji%u0161t%u011Bn%ED
54235,34,1315346400,91,44,16,10,161,A,Novela%20z.%20o%20ve%u0159ejn%E9m%20zdravotn%EDm%20poji%u0161t%u011Bn%ED
54236,34,1315346400,119,14,14,15,162,A,Novela%20z.%20o%20ve%u0159ejn%E9m%20zdravotn%EDm%20poji%u0161t%u011Bn%ED
54237,34,1315346400,120,13,15,14,162,A,Novela%20z.%20o%20ve%u0159ejn%E9m%20zdravotn%EDm%20poji%u0161t%u011Bn%ED
54238,34,1315346400,123,16,13,11,163,A,Novela%20z.%20o%20ve%u0159ejn%E9m%20zdravotn%EDm%20poji%u0161t%u011Bn%ED
54239,34,1315346400,92,22,34,15,163,A,Novela%20z.%20o%20ve%u0159ejn%E9m%20zdravotn%EDm%20poji%u0161t%u011Bn%ED
54240,34,1315346400,92,49,12,10,163,A,Novela%20z.%20o%20ve%u0159ejn%E9m%20zdravotn%EDm%20poji%u0161t%u011Bn%ED
54241,34,1315346400,92,25,32,14,163,A,Novela%20z.%20o%20ve%u0159ejn%E9m%20zdravotn%EDm%20poji%u0161t%u011Bn%ED
54242,34,1315346400,60,82,10,11,163,R,Novela%20z.%20o%20ve%u0159ejn%E9m%20zdravotn%EDm%20poji%u0161t%u011Bn%ED
54243,34,1315346400,92,36,30,5,163,A,Novela%20z.%20o%20ve%u0159ejn%E9m%20zdravotn%EDm%20poji%u0161t%u011Bn%ED
54244,34,1315346400,90,36,33,4,163,A,Novela%20z.%20o%20ve%u0159ejn%E9m%20zdravotn%EDm%20poji%u0161t%u011Bn%ED
54245,34,1315346400,97,53,12,1,163,A,Novela%20z.%20o%20ve%u0159ejn%E9m%20zdravotn%EDm%20poji%u0161t%u011Bn%ED
54246,34,1315346400,74,78,10,1,163,R,Novela%20z.%20o%20ve%u0159ejn%E9m%20zdravotn%EDm%20poji%u0161t%u011Bn%ED
54247,34,1315346400,132,12,13,7,164,A,Novela%20z.%20o%20ve%u0159ejn%E9m%20zdravotn%EDm%20poji%u0161t%u011Bn%ED
54248,34,1315346400,93,61,2,1,157,A,Novela%20z.%20o%20ve%u0159ejn%E9m%20zdravotn%EDm%20poji%u0161t%u011Bn%ED
54249,34,1315346400,95,62,0,1,158,A,Novela%20z.%20o%20ve%u0159ejn%E9m%20zdravotn%EDm%20poji%u0161t%u011Bn%ED
54250,34,1315346400,95,61,1,1,158,A,Novela%20z.%20o%20ve%u0159ejn%E9m%20zdravotn%EDm%20poji%u0161t%u011Bn%ED
54251,35,1315519200,141,1,6,0,148,A,Novela%20z.%20-%20z%E1kon%EDk%20pr%E1ce%20-%20EU
54252,35,1315519200,61,84,2,0,147,R,Novela%20z.%20-%20z%E1kon%EDk%20pr%E1ce%20-%20EU
54253,35,1315519200,120,1,23,3,147,A,Novela%20z.%20-%20z%E1kon%EDk%20pr%E1ce%20-%20EU
54254,35,1315519200,61,85,1,0,147,R,Novela%20z.%20-%20z%E1kon%EDk%20pr%E1ce%20-%20EU
54255,35,1315519200,84,19,30,15,148,A,Novela%20z.%20-%20z%E1kon%EDk%20pr%E1ce%20-%20EU
54256,35,1315519200,61,88,0,0,149,R,Novela%20z.%20-%20z%E1kon%EDk%20pr%E1ce%20-%20EU
54257,35,1315519200,62,86,0,1,149,R,Novela%20z.%20-%20z%E1kon%EDk%20pr%E1ce%20-%20EU
54258,35,1315519200,61,86,2,0,149,R,Novela%20z.%20-%20z%E1kon%EDk%20pr%E1ce%20-%20EU
54259,35,1315519200,62,87,0,0,149,R,Novela%20z.%20-%20z%E1kon%EDk%20pr%E1ce%20-%20EU
54260,35,1315519200,87,48,5,9,149,A,Novela%20z.%20-%20z%E1kon%EDk%20pr%E1ce%20-%20EU
54261,35,1315519200,87,62,0,0,149,A,Novela%20z.%20-%20z%E1kon%EDk%20pr%E1ce%20-%20EU
54262,36,1315519200,84,40,21,3,148,A,Vl.n.z.%20o%20Gener%E1ln%ED%20inspekci%20bezpe%u010Dnostn%EDch%20sbor%u016F
54263,36,1315519200,148,1,0,0,149,A,Vl.n.z.%20o%20Gener%E1ln%ED%20inspekci%20bezpe%u010Dnostn%EDch%20sbor%u016F
54264,36,1315519200,126,1,19,2,148,A,Vl.n.z.%20o%20Gener%E1ln%ED%20inspekci%20bezpe%u010Dnostn%EDch%20sbor%u016F
54265,36,1315519200,148,0,1,0,149,A,Vl.n.z.%20o%20Gener%E1ln%ED%20inspekci%20bezpe%u010Dnostn%EDch%20sbor%u016F
54266,36,1315519200,148,0,0,1,149,A,Vl.n.z.%20o%20Gener%E1ln%ED%20inspekci%20bezpe%u010Dnostn%EDch%20sbor%u016F
54267,36,1315519200,145,3,1,1,150,A,Vl.n.z.%20o%20Gener%E1ln%ED%20inspekci%20bezpe%u010Dnostn%EDch%20sbor%u016F
54268,36,1315519200,61,84,2,2,149,R,Vl.n.z.%20o%20Gener%E1ln%ED%20inspekci%20bezpe%u010Dnostn%EDch%20sbor%u016F
54269,36,1315519200,60,72,6,11,149,R,Vl.n.z.%20o%20Gener%E1ln%ED%20inspekci%20bezpe%u010Dnostn%EDch%20sbor%u016F
54270,36,1315519200,134,1,4,10,149,A,Vl.n.z.%20o%20Gener%E1ln%ED%20inspekci%20bezpe%u010Dnostn%EDch%20sbor%u016F
54271,36,1315519200,2,118,22,7,149,R,Vl.n.z.%20o%20Gener%E1ln%ED%20inspekci%20bezpe%u010Dnostn%EDch%20sbor%u016F
54272,36,1315519200,79,30,7,23,139,A,Vl.n.z.%20o%20Gener%E1ln%ED%20inspekci%20bezpe%u010Dnostn%EDch%20sbor%u016F
54273,37,1315519200,3,0,141,0,144,R,Vl.n.z.%20o%20d%u016Fchodov%E9m%20spo%u0159en%ED%20-%20EU
54274,37,1315519200,134,5,4,0,143,A,Vl.n.z.%20o%20d%u016Fchodov%E9m%20spo%u0159en%ED%20-%20EU
54275,37,1315519200,62,85,0,0,147,R,Vl.n.z.%20o%20d%u016Fchodov%E9m%20spo%u0159en%ED%20-%20EU
54276,37,1315519200,86,49,2,10,147,A,Vl.n.z.%20o%20d%u016Fchodov%E9m%20spo%u0159en%ED%20-%20EU
54277,37,1315519200,75,65,3,4,147,A,Vl.n.z.%20o%20d%u016Fchodov%E9m%20spo%u0159en%ED%20-%20EU
54278,37,1315519200,86,61,0,0,147,A,Vl.n.z.%20o%20d%u016Fchodov%E9m%20spo%u0159en%ED%20-%20EU
54279,38,1315519200,136,6,5,0,147,A,Vl.n.z.%20o%20dopl%u0148kov%E9m%20penzijn%EDm%20spo%u0159en%ED%20-%20EU
54280,38,1315519200,60,85,2,0,147,R,Vl.n.z.%20o%20dopl%u0148kov%E9m%20penzijn%EDm%20spo%u0159en%ED%20-%20EU
54281,38,1315519200,86,56,2,3,147,A,Vl.n.z.%20o%20dopl%u0148kov%E9m%20penzijn%EDm%20spo%u0159en%ED%20-%20EU
54282,38,1315519200,85,53,5,4,147,A,Vl.n.z.%20o%20dopl%u0148kov%E9m%20penzijn%EDm%20spo%u0159en%ED%20-%20EU
54283,38,1315519200,73,64,6,4,147,R,Vl.n.z.%20o%20dopl%u0148kov%E9m%20penzijn%EDm%20spo%u0159en%ED%20-%20EU
54284,38,1315519200,108,15,22,3,148,A,Vl.n.z.%20o%20dopl%u0148kov%E9m%20penzijn%EDm%20spo%u0159en%ED%20-%20EU
54285,38,1315519200,85,56,1,4,146,A,Vl.n.z.%20o%20dopl%u0148kov%E9m%20penzijn%EDm%20spo%u0159en%ED%20-%20EU
54286,38,1315519200,85,54,5,4,148,A,Vl.n.z.%20o%20dopl%u0148kov%E9m%20penzijn%EDm%20spo%u0159en%ED%20-%20EU
54287,38,1315519200,30,75,27,16,148,R,Vl.n.z.%20o%20dopl%u0148kov%E9m%20penzijn%EDm%20spo%u0159en%ED%20-%20EU
54288,38,1315519200,86,61,2,0,149,A,Vl.n.z.%20o%20dopl%u0148kov%E9m%20penzijn%EDm%20spo%u0159en%ED%20-%20EU
54289,39,1315519200,137,5,4,0,146,A,Vl.n.z.%20v%20souvislosti%20s%20p%u0159ij.%20z.%20o%20d%u016Fch.%20a%20pen.%20spo%u0159en%ED%20-%20EU
54290,39,1315519200,58,87,2,0,147,R,Vl.n.z.%20v%20souvislosti%20s%20p%u0159ij.%20z.%20o%20d%u016Fch.%20a%20pen.%20spo%u0159en%ED%20-%20EU
54291,39,1315519200,88,28,24,7,147,A,Vl.n.z.%20v%20souvislosti%20s%20p%u0159ij.%20z.%20o%20d%u016Fch.%20a%20pen.%20spo%u0159en%ED%20-%20EU
54292,39,1315519200,88,54,2,3,147,A,Vl.n.z.%20v%20souvislosti%20s%20p%u0159ij.%20z.%20o%20d%u016Fch.%20a%20pen.%20spo%u0159en%ED%20-%20EU
54293,39,1315519200,88,53,4,2,147,A,Vl.n.z.%20v%20souvislosti%20s%20p%u0159ij.%20z.%20o%20d%u016Fch.%20a%20pen.%20spo%u0159en%ED%20-%20EU
54294,39,1315519200,87,57,2,0,146,A,Vl.n.z.%20v%20souvislosti%20s%20p%u0159ij.%20z.%20o%20d%u016Fch.%20a%20pen.%20spo%u0159en%ED%20-%20EU
54295,40,1315519200,142,3,4,0,149,A,Novela%20z.%20o%20pomoci%20v%20hmotn%E9%20nouzi
54296,40,1315519200,60,85,3,1,149,R,Novela%20z.%20o%20pomoci%20v%20hmotn%E9%20nouzi
54297,40,1315519200,86,22,30,9,147,A,Novela%20z.%20o%20pomoci%20v%20hmotn%E9%20nouzi
54298,40,1315519200,143,0,4,0,147,A,Novela%20z.%20o%20pomoci%20v%20hmotn%E9%20nouzi
54299,40,1315519200,88,56,2,1,147,A,Novela%20z.%20o%20pomoci%20v%20hmotn%E9%20nouzi
54300,40,1315519200,0,144,2,1,147,R,Novela%20z.%20o%20pomoci%20v%20hmotn%E9%20nouzi
54301,40,1315519200,1,140,5,1,147,R,Novela%20z.%20o%20pomoci%20v%20hmotn%E9%20nouzi
54302,40,1315519200,58,86,3,0,147,R,Novela%20z.%20o%20pomoci%20v%20hmotn%E9%20nouzi
54303,40,1315519200,59,87,1,0,147,R,Novela%20z.%20o%20pomoci%20v%20hmotn%E9%20nouzi
54304,40,1315519200,59,87,1,0,147,R,Novela%20z.%20o%20pomoci%20v%20hmotn%E9%20nouzi
54305,40,1315519200,145,0,1,1,147,A,Novela%20z.%20o%20pomoci%20v%20hmotn%E9%20nouzi
54306,40,1315519200,89,58,0,0,147,A,Novela%20z.%20o%20pomoci%20v%20hmotn%E9%20nouzi
54307,41,1315519200,140,2,5,0,147,A,Novela%20z.%20o%20zam%u011Bstnanosti
54308,41,1315519200,59,84,0,0,143,R,Novela%20z.%20o%20zam%u011Bstnanosti
54309,41,1315519200,87,51,2,4,144,A,Novela%20z.%20o%20zam%u011Bstnanosti
54310,41,1315519200,85,30,24,4,143,A,Novela%20z.%20o%20zam%u011Bstnanosti
54311,41,1315519200,58,86,0,0,144,R,Novela%20z.%20o%20zam%u011Bstnanosti
54312,41,1315519200,60,83,1,0,144,R,Novela%20z.%20o%20zam%u011Bstnanosti
54313,41,1315519200,85,30,25,3,143,A,Novela%20z.%20o%20zam%u011Bstnanosti
54314,41,1315519200,59,83,0,1,143,R,Novela%20z.%20o%20zam%u011Bstnanosti
54315,41,1315519200,58,82,0,3,143,R,Novela%20z.%20o%20zam%u011Bstnanosti
54316,41,1315519200,84,58,1,0,143,A,Novela%20z.%20o%20zam%u011Bstnanosti
54317,42,1315519200,130,0,7,0,137,A,Vl.n.z.%20o%20poskytov%E1n%ED%20d%E1vek%20osob%E1m%20se%20zdravotn%EDm%20posti%u017Een%EDm
54318,42,1315519200,52,82,4,0,138,R,Vl.n.z.%20o%20poskytov%E1n%ED%20d%E1vek%20osob%E1m%20se%20zdravotn%EDm%20posti%u017Een%EDm
54319,42,1315519200,83,41,8,6,138,A,Vl.n.z.%20o%20poskytov%E1n%ED%20d%E1vek%20osob%E1m%20se%20zdravotn%EDm%20posti%u017Een%EDm
54320,42,1315519200,107,6,24,1,138,A,Vl.n.z.%20o%20poskytov%E1n%ED%20d%E1vek%20osob%E1m%20se%20zdravotn%EDm%20posti%u017Een%EDm
54321,42,1315519200,83,52,0,0,135,A,Vl.n.z.%20o%20poskytov%E1n%ED%20d%E1vek%20osob%E1m%20se%20zdravotn%EDm%20posti%u017Een%EDm
54322,0,1316469600,103,0,21,0,124,A,%20
54323,0,1316469600,98,48,24,7,177,A,Po%u0159ad%20sch%u016Fze
54324,0,1316469600,152,1,23,2,178,A,Po%u0159ad%20sch%u016Fze
54325,0,1316469600,126,16,19,18,179,A,Po%u0159ad%20sch%u016Fze
54326,0,1316469600,155,2,17,6,180,A,Po%u0159ad%20sch%u016Fze
54327,0,1316469600,165,1,9,0,175,A,Po%u0159ad%20sch%u016Fze
54328,0,1316469600,73,89,5,8,175,R,Po%u0159ad%20sch%u016Fze
54329,0,1316469600,71,98,4,3,176,R,Po%u0159ad%20sch%u016Fze
54330,0,1316469600,128,45,2,2,177,A,Po%u0159ad%20sch%u016Fze
54331,0,1316469600,167,3,7,0,177,A,Po%u0159ad%20sch%u016Fze
54332,0,1316469600,76,87,7,8,178,R,Po%u0159ad%20sch%u016Fze
54333,0,1316469600,125,28,19,6,178,A,Po%u0159ad%20sch%u016Fze
54334,0,1316469600,40,92,31,15,178,R,Po%u0159ad%20sch%u016Fze
54335,0,1316469600,124,23,21,10,178,A,Po%u0159ad%20sch%u016Fze
54336,0,1316469600,142,17,12,7,178,A,Po%u0159ad%20sch%u016Fze
54337,0,1316469600,133,14,23,8,178,A,Po%u0159ad%20sch%u016Fze
54338,0,1316469600,155,7,12,4,178,A,Po%u0159ad%20sch%u016Fze
54339,0,1316469600,109,15,38,16,178,A,Po%u0159ad%20sch%u016Fze
54340,0,1316469600,100,22,37,19,178,A,Po%u0159ad%20sch%u016Fze
54341,0,1316469600,98,70,1,1,170,A,Po%u0159ad%20sch%u016Fze
54342,23,1316469600,92,63,1,0,156,A,N.z.%20o%20zru%u0161en%ED%20z%E1kona%20o%20ve%u0159ej.%20nezis.%20%FAstav.%20zdrav.%20za%u0159%EDz.
54343,24,1316469600,87,56,0,1,144,A,Novela%20z.%20o%20pomoci%20v%20hmotn%E9%20nouzi
54344,27,1316469600,70,98,0,1,169,R,Vl.n.z.souvisej%EDc%ED%20se%20z%u0159%EDzen%EDm%20jednoho%20inkasn%EDho%20m%EDsta%20-%20EU
54345,27,1316469600,70,100,0,0,170,R,Vl.n.z.souvisej%EDc%ED%20se%20z%u0159%EDzen%EDm%20jednoho%20inkasn%EDho%20m%EDsta%20-%20EU
54346,27,1316469600,167,0,3,0,170,A,Vl.n.z.souvisej%EDc%ED%20se%20z%u0159%EDzen%EDm%20jednoho%20inkasn%EDho%20m%EDsta%20-%20EU
54348,27,1316469600,93,43,14,20,170,A,Vl.n.z.souvisej%EDc%ED%20se%20z%u0159%EDzen%EDm%20jednoho%20inkasn%EDho%20m%EDsta%20-%20EU
54349,27,1316469600,107,39,13,11,170,A,Vl.n.z.souvisej%EDc%ED%20se%20z%u0159%EDzen%EDm%20jednoho%20inkasn%EDho%20m%EDsta%20-%20EU
54350,27,1316469600,95,48,11,16,170,A,Vl.n.z.souvisej%EDc%ED%20se%20z%u0159%EDzen%EDm%20jednoho%20inkasn%EDho%20m%EDsta%20-%20EU
54351,27,1316469600,98,54,11,7,170,A,Vl.n.z.souvisej%EDc%ED%20se%20z%u0159%EDzen%EDm%20jednoho%20inkasn%EDho%20m%EDsta%20-%20EU
54352,27,1316469600,100,63,6,1,170,A,Vl.n.z.souvisej%EDc%ED%20se%20z%u0159%EDzen%EDm%20jednoho%20inkasn%EDho%20m%EDsta%20-%20EU
54353,26,1316469600,134,0,1,0,135,A,Vl.n.z.o%20mezin%E1rodn%ED%20pomoci%20p%u0159i%20vym%E1h%E1n%ED%20fin.pohled%E1vek%20-%20EU
54354,26,1316469600,81,40,15,5,141,A,Vl.n.z.o%20mezin%E1rodn%ED%20pomoci%20p%u0159i%20vym%E1h%E1n%ED%20fin.pohled%E1vek%20-%20EU
54355,50,1316469600,62,90,0,0,152,R,Novela%20z.%20o%20zru%u0161en%ED%20Fondu%20n%E1rodn%EDho%20majetku
54356,50,1316469600,152,2,0,0,154,A,Novela%20z.%20o%20zru%u0161en%ED%20Fondu%20n%E1rodn%EDho%20majetku
54357,50,1316469600,92,61,1,0,154,A,Novela%20z.%20o%20zru%u0161en%ED%20Fondu%20n%E1rodn%EDho%20majetku
54358,10,1316469600,84,18,19,9,130,A,Novela%20z.%20o%20uv%E1d%u011Bn%ED%20biocidn%EDch%20p%u0159%EDpravk%u016F%20na%20trh
54359,11,1316469600,82,48,2,3,135,A,Novela%20z.%20o%20z%EDsk%E1v%E1n%ED%20zp%u016Fsob.%20k%20v%FDkonu%20zdrav.%20povol%E1n%ED
54360,37,1316469600,121,1,12,0,134,A,Novela%20z.%20o%20lidsk%FDch%20tk%E1n%EDch%20a%20bu%u0148k%E1ch
54361,38,1316469600,55,74,1,1,131,R,Novela%20z.%20o%20ochran%u011B%20ve%u0159ejn%E9ho%20zdrav%ED
54362,38,1316469600,54,75,1,1,131,R,Novela%20z.%20o%20ochran%u011B%20ve%u0159ejn%E9ho%20zdrav%ED
54363,38,1316469600,133,0,0,0,133,A,Novela%20z.%20o%20ochran%u011B%20ve%u0159ejn%E9ho%20zdrav%ED
54364,38,1316469600,54,72,3,3,132,R,Novela%20z.%20o%20ochran%u011B%20ve%u0159ejn%E9ho%20zdrav%ED
54365,38,1316469600,56,68,2,6,132,R,Novela%20z.%20o%20ochran%u011B%20ve%u0159ejn%E9ho%20zdrav%ED
54366,64,1316469600,125,0,9,1,135,A,R%E1mcov%E1%20%FAmluva%20o%20kontrole%20tab%E1ku
54367,64,1316469600,123,5,7,1,136,A,R%E1mcov%E1%20%FAmluva%20o%20kontrole%20tab%E1ku
54368,32,1316469600,26,81,11,18,136,R,Novela%20z.%20-%20%DAstava%20%u010Cesk%E9%20republiky
54369,32,1316469600,129,1,10,0,140,A,Novela%20z.%20-%20%DAstava%20%u010Cesk%E9%20republiky
54370,0,1316556000,93,3,17,1,114,A,%20
54371,0,1316556000,70,28,21,3,122,A,Po%u0159ad%20sch%u016Fze
54372,8,1316556000,106,13,6,6,131,A,Vl.n.z.%20o%20chemick%FDch%20l%E1tk%E1ch%20%28chemick%FD%20z%E1kon%29%20-%20EU
54373,9,1316556000,124,4,11,1,140,A,Novela%20z.%20o%20obchodov%E1n%ED%20s%20ohro%u017Een%FDmi%20druhy%20-%20EU
54374,34,1316556000,137,1,15,0,153,A,Vl.n.z.%20o%20l%E1tk%E1ch%2C%20kter%E9%20po%u0161kozuj%ED%20ozonovou%20vrstvu%20-%20EU
54375,35,1316556000,147,0,12,0,159,A,Vl.n.z.%20o%20ochran%u011B%20ovzdu%u0161%ED%20-%20EU
54376,35,1316556000,127,14,16,3,160,A,Vl.n.z.%20o%20ochran%u011B%20ovzdu%u0161%ED%20-%20EU
54377,71,1316556000,130,0,29,0,159,A,Prot.%20k%20R%E1mcov%E9%20%FAml.%20o%20ochran%u011B%20a%20udr%u017Eiteln%E9m%20rozvoji%20Karpat
54378,72,1316556000,123,0,34,0,157,A,Nagojsko-kualalumpursk%FD%20prot.%20o%20odpov%u011Bdnosti%20a%20n%E1hr.%u0161kod
54379,1,1316556000,70,43,45,6,164,R,Novela%20z.%20o%20Rejst%u0159%EDku%20trest%u016F%20-%20EU
54380,1,1316556000,107,11,10,11,139,A,Novela%20z.%20o%20Rejst%u0159%EDku%20trest%u016F%20-%20EU
54381,1,1316556000,76,53,2,8,139,A,Novela%20z.%20o%20Rejst%u0159%EDku%20trest%u016F%20-%20EU
54382,2,1316556000,43,82,4,10,139,R,N.z.o%20trestn%ED%20odpov%u011Bdnosti%20pr%E1v.%20osob%20a%20%u0159%EDzen%ED%20proti%20nim%20-%20EU
54383,4,1316556000,69,57,2,1,129,A,Novela%20obchodn%EDho%20z%E1kon%EDku%20-%20EU
54384,6,1316556000,64,54,0,2,120,A,Novela%20z.%20o%20trestn%EDm%20%u0159%EDzen%ED%20soudn%EDm%20%28trestn%ED%20%u0159%E1d%29%20-%20EU
54385,7,1316556000,65,51,0,1,117,A,Novela%20z.%20o%20p%u0159em%u011Bn%E1ch%20obchodn%EDch%20spole%u010Dnost%ED%20a%20dru%u017Estev%20-%20EU
54386,14,1316556000,75,47,4,3,129,A,Novela%20z.%20o%20z%E1pisech%20vlastnick%FDch%20pr%E1v%20k%20nemovitostem
54387,17,1316556000,66,51,1,0,118,A,Novela%20z.%20o%20platu%20st%E1tn%EDch%20z%E1stupc%u016F
54388,18,1316556000,70,37,11,0,118,A,Novela%20z.%20o%20zam%u011Bstnanosti%20-%20EU
54389,19,1316556000,76,50,3,0,129,A,Novela%20z.%20o%20slu%u017Eb%u011B%20st%E1tn%EDch%20zam%u011Bstnanc%u016F
54390,25,1316556000,116,0,21,1,138,A,Novela%20z.o%20podpo%u0159e%20v%FDzkumu%2Cexperiment%E1ln%EDho%20v%FDvoje%20a%20inovac%ED
54391,25,1316556000,84,27,9,0,120,A,Novela%20z.o%20podpo%u0159e%20v%FDzkumu%2Cexperiment%E1ln%EDho%20v%FDvoje%20a%20inovac%ED
54392,28,1316556000,118,0,11,0,129,A,Novela%20z.%20o%20uzn%E1v%E1n%ED%20odborn%E9%20kvalifikace%20-%20EU
54393,29,1316556000,115,2,19,1,137,A,Novela%20z.%20o%20uzn%E1v%E1n%ED%20v%FDsledk%u016F%20dal%u0161%EDho%20vzd%u011Bl%E1v%E1n%ED
54394,30,1316556000,119,1,19,1,140,A,Novela%20z.%20o%20ob%u011Bhu%20osiva%20a%20sadby%20-%20EU
54395,12,1316556000,64,38,33,3,138,R,Novela%20z.%20o%20elektronick%FDch%20komunikac%EDch%20-%20EU
54396,31,1316556000,131,1,2,1,135,A,Novela%20z.%20o%20podm%EDnk%E1ch%20p%u0159evodu%20zem%u011Bd%u011Bl.%20a%20lesn%EDch%20pozemk%u016F%20-%20EU
54397,33,1316556000,124,1,18,0,143,A,Vl.n.z.%20o%20mediaci%20-%20EU
54398,36,1316556000,126,1,16,1,144,A,Novela%20z.%20o%20hospod%E1%u0159sk%FDch%20opat%u0159en%EDch%20pro%20krizov%E9%20stavy
54399,39,1316556000,31,1,114,0,146,R,Novela%20z.%20o%20m%EDstn%EDch%20poplatc%EDch
54400,39,1316556000,136,1,13,1,151,A,Novela%20z.%20o%20m%EDstn%EDch%20poplatc%EDch
54401,39,1316556000,121,12,16,2,151,A,Novela%20z.%20o%20m%EDstn%EDch%20poplatc%EDch
54402,39,1316556000,96,34,18,3,151,A,Novela%20z.%20o%20m%EDstn%EDch%20poplatc%EDch
54403,39,1316556000,65,61,17,8,151,R,Novela%20z.%20o%20m%EDstn%EDch%20poplatc%EDch
54404,0,1316642400,67,0,18,0,85,A,%20
54405,0,1316642400,68,77,4,0,149,R,Po%u0159ad%20sch%u016Fze
54406,0,1316642400,92,3,18,6,119,A,%20
54407,102,1316642400,93,5,26,2,126,A,N%E1vrh%20harmonogramu%20projedn%E1v%E1n%ED%20n%E1vrhu%20st%E1tn%EDho%20rozpo%u010Dtu%202012
54408,52,1316642400,115,0,19,0,134,A,Sml.%20mezi%20%u010CR%20a%20vl.%20Rep.%20Kazachst%E1n%20p%u0159eb%EDr%E1n%ED%20osob
54409,53,1316642400,117,1,14,0,132,A,Doh.mezi%20%u010CR%20a%20Irskem%20o%20podpo%u0159e%20a%20vz%E1jemn%E9%20ochran%u011B%20investic
54410,54,1316642400,111,0,21,0,132,A,Doh.%20mezi%20%u010CR%20a%20Sr%EDlanskou%20dem.%20soc.%20rep.%20o%20podpo%u0159e%20investic
54411,55,1316642400,110,1,21,0,132,A,Charta%20Mezin%E1rodn%EDho%20energetick%E9ho%20f%F3ra
54412,56,1316642400,109,0,22,0,131,A,Sml.%20mezi%20%u010CR%20a%20Lucem.%20velkov%E9v.%20o%20v%FDm.%20a%20ochr.%20utaj.%20infom.
54413,57,1316642400,104,1,27,0,132,A,Doh.%20mezi%20st%E1ty%20EU%20a%20Gruzi%ED%20o%20spol.%20leteck%E9m%20prostoru
54414,58,1316642400,109,0,23,0,132,A,Evr.-st%u0159edomo%u0159.%20let.doh.mezi%20st%E1ty%20EU%20a%20Jord%E1nsk%FDm%20h%E1%u0161.kr%E1l.
54415,59,1316642400,109,1,21,0,131,A,Doh.%20mezi%20%u010CR%20a%20vl.%20Argentinsk%E9%20rep.%20o%20leteck%FDch%20slu%u017Eb%E1ch
54416,60,1316642400,108,0,24,0,132,A,Doh.%20o%20z%u0159%EDzen%ED%20St%u0159edoevr.%20funk%u010Dn%EDho%20bloku%20vzdu%u0161n%E9ho%20prostoru
54417,61,1316642400,110,1,24,0,135,A,Doh.o%20z%u0159%EDzen%ED%20a%20provozov%E1n%ED%20letov%FDch%20slu%u017Eeb%20org.%20EUROCONTROL
54418,62,1316642400,115,1,21,0,137,A,Mezin%E1rodn%ED%20%FAmluva%20proti%20dopingu%20ve%20sportu
54419,63,1316642400,108,0,28,0,136,A,Doporu%u010Den%ED%20MOP%20%u010D.%20200%20o%20HIV%20a%20AIDS%20a%20sv%u011Bt%u011B%20pr%E1ce
54420,63,1316642400,97,7,30,2,136,A,Doporu%u010Den%ED%20MOP%20%u010D.%20200%20o%20HIV%20a%20AIDS%20a%20sv%u011Bt%u011B%20pr%E1ce
54421,65,1316642400,104,1,31,0,136,A,Doh.mezi%20%u010CR%20a%20%C1zerb%E1jd%u017E%E1nskou%20rep.%20o%20podpo%u0159e%20a%20ochr.investic
54422,66,1316642400,106,1,27,0,134,A,Sml.%20mezi%20%u010CR%20a%20Kr%E1l.%20Bahrajn%20o%20zamezen%ED%20dvoj.%20zdan%u011Bn%ED
54423,67,1316642400,111,0,23,0,134,A,Sml.%20mezi%20%u010CR%20a%20vl.%20Hongkongu%20o%20zamezen%ED%20dvoj%EDmu%20zdan%u011Bn%ED
54424,68,1316642400,110,1,22,0,133,A,Doh.%20o%20Mezin%E1rodn%ED%20bance%20pro%20obnovu%20a%20rozvoj
54425,69,1316642400,113,0,22,0,135,A,Doh.%20mezi%20%u010CR%20a%20vl%E1dou%20Brit.Panen.ostrov%u016F%20o%20v%FDm%u011Bn%u011B%20informac%ED
54426,70,1316642400,111,0,22,1,134,A,Prot.%20o%20trvale%20udr%u017Eiteln%E9m%20obhospoda%u0159ov%E1n%ED%20les%u016F
54427,70,1316642400,111,0,23,0,134,A,Prot.%20o%20trvale%20udr%u017Eiteln%E9m%20obhospoda%u0159ov%E1n%ED%20les%u016F
54428,73,1316642400,105,1,26,0,132,A,Sml.mezi%20%u010CR%20a%20Kyperskou%20rep.%20o%20vz%E1jemn%E9%20ochr.%20utaj.informac%ED
54429,74,1316642400,107,1,23,0,131,A,Doh.%20mezi%20st%E1ty%20EU%20o%20ochran%u011B%20utajovan%FDch%20informac%ED
54430,75,1316642400,104,1,26,0,131,A,Sml.%20mezi%20%u010CR%20a%20vl.%20%C1zerb%E1jd.rep.%20o%20ochr.%20utaj.%20informac%ED
54431,76,1316642400,108,1,23,0,132,A,Doh.%20mezi%20%u010CR%20a%20Organiz.%20pro%20z%E1kaz%20chem.%20zbran%ED%20o%20inspekc%EDch
54432,77,1316642400,49,43,5,11,108,R,Sml.%20mezi%20%u010CR%20a%20Rep.%20Kosovo%20o%20zp%u011Btn%E9m%20p%u0159eb%EDr%E1n%ED%20osob
54433,77,1316642400,77,29,3,3,112,A,Sml.%20mezi%20%u010CR%20a%20Rep.%20Kosovo%20o%20zp%u011Btn%E9m%20p%u0159eb%EDr%E1n%ED%20osob
54434,105,1316642400,64,18,0,2,84,A,P%u0159ehled%20o%20%u010Dinnosti%20cenov%FDch%20kontroln%EDch%20org%E1n%u016F%20za%20rok%202010
54435,106,1316642400,78,2,7,2,89,A,Inf.%20o%20realizaci%20protipovod%u0148ov%FDch%20opat%u0159en%ED%20v%20%u010CR%20za%20rok%202010
54436,107,1316642400,79,4,8,1,92,A,Zpr%E1va%20o%20stavu%20zem%u011Bd%u011Blstv%ED%20%u010CR%20za%20rok%202010
54437,108,1316642400,79,2,5,4,90,A,V%FDro%u010Dn%ED%20zpr%E1va%20o%20%u010Dinnosti%20Pozemkov%E9ho%20fondu%20%u010CR%20za%20rok%202010
54438,109,1316642400,73,3,13,2,91,A,1.%20dopln%u011Bk%20pl%E1nu%20voj.%20cvi%u010Den%ED%20A%u010CR%20se%20zahrani%u010Dn%EDmi%20partnery
54439,110,1316642400,16,2,73,0,91,R,Inf.%20o%20nasazen%ED%20sil%20MO%20v%20zahrani%u010Dn%EDch%20operac%EDch%20v%20roce%202010
54440,110,1316642400,62,22,0,3,87,A,Inf.%20o%20nasazen%ED%20sil%20MO%20v%20zahrani%u010Dn%EDch%20operac%EDch%20v%20roce%202010
54441,111,1316642400,78,2,5,3,88,A,Zpr%E1va%20o%20v%FDvoji%20mal%E9ho%20a%20st%u0159edn%EDho%20podnik%E1n%ED%20v%20roce%202010
54442,0,1316728800,112,8,11,1,132,A,Po%u0159ad%20sch%u016Fze
54443,0,1316728800,104,12,16,4,136,A,Po%u0159ad%20sch%u016Fze
54444,0,1316728800,109,0,29,1,139,A,Po%u0159ad%20sch%u016Fze
54445,0,1316728800,84,33,25,4,146,A,Po%u0159ad%20sch%u016Fze
54446,0,1316728800,82,21,38,5,146,A,Po%u0159ad%20sch%u016Fze
54447,13,1316728800,117,1,33,0,151,A,Vl.n.z.%20o%20podporovan%FDch%20zdroj%EDch%20energie%20-%20EU
54448,87,1316728800,143,0,12,0,155,A,Novela%20z.%20o%20uv%E1d%u011Bn%ED%20biocidn%EDch%20p%u0159%EDpravk%u016F%20na%20trh
54449,87,1316728800,151,1,3,0,155,A,Novela%20z.%20o%20uv%E1d%u011Bn%ED%20biocidn%EDch%20p%u0159%EDpravk%u016F%20na%20trh
54450,88,1316728800,63,85,6,2,156,R,Novela%20z.%20o%20z%EDsk%E1v%E1n%ED%20zp%u016Fsob.%20k%20v%FDkonu%20zdrav.%20povol%E1n%ED
54451,88,1316728800,147,2,7,0,156,A,Novela%20z.%20o%20z%EDsk%E1v%E1n%ED%20zp%u016Fsob.%20k%20v%FDkonu%20zdrav.%20povol%E1n%ED
54452,88,1316728800,89,15,31,21,156,A,Novela%20z.%20o%20z%EDsk%E1v%E1n%ED%20zp%u016Fsob.%20k%20v%FDkonu%20zdrav.%20povol%E1n%ED
54453,100,1316728800,64,83,11,0,158,R,N.z.%20o%20zru%u0161en%ED%20z%E1kona%20o%20ve%u0159ej.%20nezis.%20%FAstav.%20zdrav.%20za%u0159%EDz.
54454,100,1316728800,85,42,29,3,159,A,N.z.%20o%20zru%u0161en%ED%20z%E1kona%20o%20ve%u0159ej.%20nezis.%20%FAstav.%20zdrav.%20za%u0159%EDz.
54455,100,1316728800,83,65,10,1,159,A,N.z.%20o%20zru%u0161en%ED%20z%E1kona%20o%20ve%u0159ej.%20nezis.%20%FAstav.%20zdrav.%20za%u0159%EDz.
54456,101,1316728800,88,49,2,12,151,A,Novela%20z.%20o%20pomoci%20v%20hmotn%E9%20nouzi
54457,101,1316728800,87,61,1,3,152,A,Novela%20z.%20o%20pomoci%20v%20hmotn%E9%20nouzi
54458,86,1316728800,132,1,15,0,148,A,Novela%20z.%20o%20obchodov%E1n%ED%20s%20ohro%u017Een%FDmi%20druhy%20-%20EU
54459,94,1316728800,137,0,13,0,150,A,Novela%20z.%20o%20platu%20st%E1tn%EDch%20z%E1stupc%u016F
54460,96,1316728800,80,41,26,1,148,A,Novela%20z.%20o%20slu%u017Eb%u011B%20st%E1tn%EDch%20zam%u011Bstnanc%u016F
54461,99,1316728800,127,0,18,0,145,A,Novela%20z.%20o%20v%FDkonu%20%FAstavn%ED%20v%FDchovy
54462,85,1316728800,123,0,21,0,144,A,Vl.n.z.%20o%20chemick%FDch%20l%E1tk%E1ch%20%28chemick%FD%20z%E1kon%29%20-%20EU
54463,85,1316728800,126,0,18,0,144,A,Vl.n.z.%20o%20chemick%FDch%20l%E1tk%E1ch%20%28chemick%FD%20z%E1kon%29%20-%20EU
54464,85,1316728800,106,2,36,1,145,A,Vl.n.z.%20o%20chemick%FDch%20l%E1tk%E1ch%20%28chemick%FD%20z%E1kon%29%20-%20EU
54465,78,1316728800,130,0,15,0,145,A,Novela%20z.%20o%20Rejst%u0159%EDku%20trest%u016F%20-%20EU
54466,78,1316728800,126,1,17,1,145,A,Novela%20z.%20o%20Rejst%u0159%EDku%20trest%u016F%20-%20EU
54467,78,1316728800,90,32,16,7,145,A,Novela%20z.%20o%20Rejst%u0159%EDku%20trest%u016F%20-%20EU
54468,78,1316728800,98,25,15,5,143,A,Novela%20z.%20o%20Rejst%u0159%EDku%20trest%u016F%20-%20EU
54469,81,1316728800,121,0,20,1,142,A,Novela%20obchodn%EDho%20z%E1kon%EDku%20-%20EU
54470,81,1316728800,119,0,21,2,142,A,Novela%20obchodn%EDho%20z%E1kon%EDku%20-%20EU
54471,81,1316728800,37,78,24,3,142,R,Novela%20obchodn%EDho%20z%E1kon%EDku%20-%20EU
54472,81,1316728800,85,10,37,10,142,A,Novela%20obchodn%EDho%20z%E1kon%EDku%20-%20EU
54473,83,1316728800,128,1,16,0,145,A,Novela%20z.%20o%20trestn%EDm%20%u0159%EDzen%ED%20soudn%EDm%20%28trestn%ED%20%u0159%E1d%29%20-%20EU
54474,83,1316728800,56,67,16,6,145,R,Novela%20z.%20o%20trestn%EDm%20%u0159%EDzen%ED%20soudn%EDm%20%28trestn%ED%20%u0159%E1d%29%20-%20EU
54475,83,1316728800,103,10,19,12,144,A,Novela%20z.%20o%20trestn%EDm%20%u0159%EDzen%ED%20soudn%EDm%20%28trestn%ED%20%u0159%E1d%29%20-%20EU
54476,91,1316728800,126,1,14,2,143,A,Novela%20z.%20o%20z%E1pisech%20vlastnick%FDch%20pr%E1v%20k%20nemovitostem
54477,91,1316728800,131,0,13,0,144,A,Novela%20z.%20o%20z%E1pisech%20vlastnick%FDch%20pr%E1v%20k%20nemovitostem
54478,91,1316728800,82,27,33,2,144,A,Novela%20z.%20o%20z%E1pisech%20vlastnick%FDch%20pr%E1v%20k%20nemovitostem
54479,0,1317074400,133,2,6,0,141,A,Po%u0159ad%20sch%u016Fze
54480,0,1317074400,144,1,1,0,146,A,Po%u0159ad%20sch%u016Fze
54481,0,1317074400,133,5,3,7,148,A,Po%u0159ad%20sch%u016Fze
54482,0,1317074400,142,1,4,2,149,A,Po%u0159ad%20sch%u016Fze
54483,0,1317074400,90,27,26,6,149,A,Po%u0159ad%20sch%u016Fze
54484,0,1317074400,132,5,11,2,150,A,Po%u0159ad%20sch%u016Fze
54485,79,1317074400,143,2,9,0,154,A,N.z.o%20trestn%ED%20odpov%u011Bdnosti%20pr%E1v.%20osob%20a%20%u0159%EDzen%ED%20proti%20nim%20-%20EU
54486,79,1317074400,34,99,17,6,156,R,N.z.o%20trestn%ED%20odpov%u011Bdnosti%20pr%E1v.%20osob%20a%20%u0159%EDzen%ED%20proti%20nim%20-%20EU
54487,79,1317074400,148,1,7,0,156,A,N.z.o%20trestn%ED%20odpov%u011Bdnosti%20pr%E1v.%20osob%20a%20%u0159%EDzen%ED%20proti%20nim%20-%20EU
54488,79,1317074400,18,100,23,16,157,R,N.z.o%20trestn%ED%20odpov%u011Bdnosti%20pr%E1v.%20osob%20a%20%u0159%EDzen%ED%20proti%20nim%20-%20EU
54489,79,1317074400,1,135,12,9,157,R,N.z.o%20trestn%ED%20odpov%u011Bdnosti%20pr%E1v.%20osob%20a%20%u0159%EDzen%ED%20proti%20nim%20-%20EU
54490,79,1317074400,127,0,28,2,157,A,N.z.o%20trestn%ED%20odpov%u011Bdnosti%20pr%E1v.%20osob%20a%20%u0159%EDzen%ED%20proti%20nim%20-%20EU
54491,79,1317074400,122,25,8,1,156,A,N.z.o%20trestn%ED%20odpov%u011Bdnosti%20pr%E1v.%20osob%20a%20%u0159%EDzen%ED%20proti%20nim%20-%20EU
54492,80,1317074400,144,1,10,0,155,A,N.z.%20o%20zm%u011Bn%u011B%20z%E1kon%u016F%20v%20souvisl.s%20p%u0159ij.z%E1k.o%20tr.odpov%u011Bdnosti
54493,80,1317074400,4,107,38,5,154,R,N.z.%20o%20zm%u011Bn%u011B%20z%E1kon%u016F%20v%20souvisl.s%20p%u0159ij.z%E1k.o%20tr.odpov%u011Bdnosti
54494,80,1317074400,118,0,34,2,154,A,N.z.%20o%20zm%u011Bn%u011B%20z%E1kon%u016F%20v%20souvisl.s%20p%u0159ij.z%E1k.o%20tr.odpov%u011Bdnosti
54495,80,1317074400,46,71,33,5,155,R,N.z.%20o%20zm%u011Bn%u011B%20z%E1kon%u016F%20v%20souvisl.s%20p%u0159ij.z%E1k.o%20tr.odpov%u011Bdnosti
54496,80,1317074400,123,0,29,2,154,A,N.z.%20o%20zm%u011Bn%u011B%20z%E1kon%u016F%20v%20souvisl.s%20p%u0159ij.z%E1k.o%20tr.odpov%u011Bdnosti
54497,80,1317074400,122,1,30,1,154,A,N.z.%20o%20zm%u011Bn%u011B%20z%E1kon%u016F%20v%20souvisl.s%20p%u0159ij.z%E1k.o%20tr.odpov%u011Bdnosti
54498,80,1317074400,124,0,29,1,154,A,N.z.%20o%20zm%u011Bn%u011B%20z%E1kon%u016F%20v%20souvisl.s%20p%u0159ij.z%E1k.o%20tr.odpov%u011Bdnosti
54499,82,1317074400,137,0,18,0,155,A,Novela%20z.%20o%20znalc%EDch%20a%20tlumo%u010Dn%EDc%EDch
54500,82,1317074400,137,2,16,0,155,A,Novela%20z.%20o%20znalc%EDch%20a%20tlumo%u010Dn%EDc%EDch
54501,82,1317074400,144,0,11,0,155,A,Novela%20z.%20o%20znalc%EDch%20a%20tlumo%u010Dn%EDc%EDch
54502,82,1317074400,37,80,33,3,153,R,Novela%20z.%20o%20znalc%EDch%20a%20tlumo%u010Dn%EDc%EDch
54503,82,1317074400,32,107,13,3,155,R,Novela%20z.%20o%20znalc%EDch%20a%20tlumo%u010Dn%EDc%EDch
54504,82,1317074400,143,2,9,2,156,A,Novela%20z.%20o%20znalc%EDch%20a%20tlumo%u010Dn%EDc%EDch
54505,84,1317074400,136,2,17,2,157,A,Novela%20z.%20o%20p%u0159em%u011Bn%E1ch%20obchodn%EDch%20spole%u010Dnost%ED%20a%20dru%u017Estev%20-%20EU
54506,84,1317074400,87,19,37,14,157,A,Novela%20z.%20o%20p%u0159em%u011Bn%E1ch%20obchodn%EDch%20spole%u010Dnost%ED%20a%20dru%u017Estev%20-%20EU
54507,97,1317074400,148,3,6,0,157,A,Novela%20z.%20o%20rozpo%u010Dtov%FDch%20pravidlech
54508,97,1317074400,146,0,10,2,158,A,Novela%20z.%20o%20rozpo%u010Dtov%FDch%20pravidlech
54509,97,1317074400,124,24,6,4,158,A,Novela%20z.%20o%20rozpo%u010Dtov%FDch%20pravidlech
54510,97,1317074400,151,0,7,0,158,A,Novela%20z.%20o%20rozpo%u010Dtov%FDch%20pravidlech
54511,97,1317074400,89,46,14,9,158,A,Novela%20z.%20o%20rozpo%u010Dtov%FDch%20pravidlech
54512,97,1317074400,16,80,34,28,158,R,Novela%20z.%20o%20rozpo%u010Dtov%FDch%20pravidlech
54513,97,1317074400,143,4,9,2,158,A,Novela%20z.%20o%20rozpo%u010Dtov%FDch%20pravidlech
54514,98,1317074400,149,1,8,1,159,A,Novela%20z.%20o%20zvl%E1%u0161tn%ED%20ochran%u011B%20sv%u011Bdka
54515,98,1317074400,65,83,11,1,160,R,Novela%20z.%20o%20zvl%E1%u0161tn%ED%20ochran%u011B%20sv%u011Bdka
54516,98,1317074400,92,18,33,17,160,A,Novela%20z.%20o%20zvl%E1%u0161tn%ED%20ochran%u011B%20sv%u011Bdka
54517,49,1317074400,64,57,11,17,149,R,Novela%20z.%20o%20p%u0159estupc%EDch
54518,49,1317074400,143,1,6,1,151,A,Novela%20z.%20o%20p%u0159estupc%EDch
54519,49,1317074400,59,71,4,20,154,R,Novela%20z.%20o%20p%u0159estupc%EDch
54520,49,1317074400,153,0,4,0,157,A,Novela%20z.%20o%20p%u0159estupc%EDch
54521,49,1317074400,67,62,17,12,158,R,Novela%20z.%20o%20p%u0159estupc%EDch
54522,49,1317074400,96,38,17,7,158,A,Novela%20z.%20o%20p%u0159estupc%EDch
54523,49,1317074400,98,40,17,3,158,A,Novela%20z.%20o%20p%u0159estupc%EDch
54524,92,1317074400,145,1,12,1,159,A,Novela%20z.%20o%20ekologick%E9m%20zem%u011Bd%u011Blstv%ED%20-%20EU
54525,92,1317074400,148,1,10,0,159,A,Novela%20z.%20o%20ekologick%E9m%20zem%u011Bd%u011Blstv%ED%20-%20EU
54526,92,1317074400,149,1,9,0,159,A,Novela%20z.%20o%20ekologick%E9m%20zem%u011Bd%u011Blstv%ED%20-%20EU
54527,93,1317074400,143,0,14,0,157,A,Novela%20z.%20o%20Pozemkov%E9m%20fondu%20%u010CR
54528,93,1317074400,146,1,10,0,157,A,Novela%20z.%20o%20Pozemkov%E9m%20fondu%20%u010CR
54529,40,1317074400,86,57,1,0,144,A,Novela%20z.%20o%20dan%EDch%20z%20p%u0159%EDjm%u016F
54530,89,1317074400,115,5,6,2,128,A,Novela%20z.%20o%20elektronick%FDch%20komunikac%EDch%20-%20EU
54531,89,1317074400,132,0,0,0,132,A,Novela%20z.%20o%20elektronick%FDch%20komunikac%EDch%20-%20EU
54532,89,1317074400,131,0,2,0,133,A,Novela%20z.%20o%20elektronick%FDch%20komunikac%EDch%20-%20EU
54533,89,1317074400,31,102,6,1,140,R,Novela%20z.%20o%20elektronick%FDch%20komunikac%EDch%20-%20EU
54534,89,1317074400,135,2,3,0,140,A,Novela%20z.%20o%20elektronick%FDch%20komunikac%EDch%20-%20EU
54535,0,1317074400,89,30,12,9,140,A,%20
54536,0,1319493600,92,0,14,2,108,A,%20
54537,0,1319493600,102,73,7,4,186,A,Po%u0159ad%20sch%u016Fze
54538,0,1319493600,105,37,34,12,188,A,Po%u0159ad%20sch%u016Fze
54539,0,1319493600,177,2,7,2,188,A,Po%u0159ad%20sch%u016Fze
54540,0,1319493600,129,11,33,13,186,A,Po%u0159ad%20sch%u016Fze
54541,0,1319493600,172,2,5,7,186,A,Po%u0159ad%20sch%u016Fze
54542,0,1319493600,106,70,6,4,186,A,Po%u0159ad%20sch%u016Fze
54543,0,1319493600,103,49,29,5,186,A,Po%u0159ad%20sch%u016Fze
54544,0,1319493600,81,92,7,6,186,R,Po%u0159ad%20sch%u016Fze
54545,0,1319493600,76,80,16,14,186,R,Po%u0159ad%20sch%u016Fze
54546,0,1319493600,77,85,8,16,186,R,Po%u0159ad%20sch%u016Fze
54547,0,1319493600,81,75,12,18,186,R,Po%u0159ad%20sch%u016Fze
54548,0,1319493600,75,76,16,19,186,R,Po%u0159ad%20sch%u016Fze
54549,0,1319493600,72,101,9,4,186,R,Po%u0159ad%20sch%u016Fze
54550,0,1319493600,107,27,39,13,186,A,Po%u0159ad%20sch%u016Fze
54551,0,1319493600,82,87,10,7,186,R,Po%u0159ad%20sch%u016Fze
54552,0,1319493600,79,99,6,3,187,R,Po%u0159ad%20sch%u016Fze
54553,0,1319493600,79,99,7,2,187,R,Po%u0159ad%20sch%u016Fze
54554,0,1319493600,79,89,8,10,186,R,Po%u0159ad%20sch%u016Fze
54555,0,1319493600,133,24,13,17,187,A,Po%u0159ad%20sch%u016Fze
54556,0,1319493600,103,76,4,4,187,A,Po%u0159ad%20sch%u016Fze
54557,2,1319493600,94,67,0,1,162,A,N%E1vrh%20na%20zkr%E1cen%ED%20lh%u016Ft%20pro%20projedn%E1n%ED%20tisk%u016F%20450%20a%20451%20v%20PS
54558,3,1319493600,95,68,2,2,167,A,N%E1vrh%20na%20zkr%E1cen%ED%20lh%u016Ft%20pro%20projedn%E1n%ED%20tisk%u016F%20452%20a%20453%20v%20PS
54559,17,1319493600,118,1,54,0,173,A,Vl.n.z.%20v%20souvislosti%20s%20reformou%20dohledu%20nad%20fin.%20trhem%20v%20EU%20-%20EU
54560,17,1319493600,87,25,59,2,173,A,Vl.n.z.%20v%20souvislosti%20s%20reformou%20dohledu%20nad%20fin.%20trhem%20v%20EU%20-%20EU
54561,9,1319493600,115,0,54,2,171,A,Novela%20z.%20o%20vzd%u011Bl%E1v%E1n%ED%20-%20%u0161kolsk%FD%20z%E1kon
54562,0,1319580000,75,33,13,11,132,A,Po%u0159ad%20sch%u016Fze
54563,0,1319580000,105,8,12,9,134,A,Po%u0159ad%20sch%u016Fze
54564,14,1319580000,140,0,29,2,171,A,Novela%20z.%20o%20voj%E1c%EDch%20z%20povol%E1n%ED
54565,15,1319580000,133,4,37,2,176,A,Novela%20z.%20o%20ve%u0159ejn%FDch%20sb%EDrk%E1ch
54566,16,1319580000,143,1,38,0,182,A,Novela%20z.%20o%20pedagogick%FDch%20pracovn%EDc%EDch
54567,18,1319580000,137,1,2,0,140,A,Novela%20z.%20o%20rodin%u011B
54568,18,1319580000,113,6,23,2,144,A,Novela%20z.%20o%20rodin%u011B
54569,19,1319580000,65,89,11,1,166,R,Novela%20z.%20o%20pozemn%EDch%20komunikac%EDch
54570,19,1319580000,155,1,10,0,166,A,Novela%20z.%20o%20pozemn%EDch%20komunikac%EDch
54571,19,1319580000,85,40,25,17,167,A,Novela%20z.%20o%20pozemn%EDch%20komunikac%EDch
54572,20,1319580000,120,1,42,2,165,A,Novela%20z.%20o%20rostlinol%E9ka%u0159sk%E9%20p%E9%u010Di%20-%20EU
54573,21,1319580000,93,71,0,2,166,A,Novela%20z.%20-%20trestn%ED%20z%E1kon%EDk
54574,22,1319580000,77,63,0,2,142,A,N.z.%20o%20zp%u016Fsobu%20uzn%E1v%E1n%ED%20nov%u011B%20vznikl%FDch%20st%E1t%u016F%20%u010Ceskou%20rep.
54575,23,1319580000,86,59,1,1,147,A,Novela%20z.%20o%20sdru%u017Eov%E1n%ED%20v%20politick%FDch%20stran%E1ch%20a%20hnut%EDch
54576,24,1319580000,98,30,2,9,139,A,N.z.o%20zru%u0161en%ED%20z.o%20z%E1kazu%20dod%E1vek%20pro%20jader.elektr%E1rnu%20B%FA%u0161ehr
54577,42,1319580000,96,0,0,0,96,A,R%E1mcov%E1%20doh.%20o%20partnerstv%ED%20mezi%20st%E1ty%20ES%20a%20Indon%E9skou%20rep.
54578,44,1319580000,95,1,5,0,101,A,V%u0161eobecn%E9%20dohody%20o%20obchodu%20a%20slu%u017Eb%E1ch%20%28GATS%29
54579,43,1319580000,112,1,13,0,126,A,Doh.%20mezi%20%u010CR%20a%20Organizac%ED%20pro%20z%E1kaz%20chemick%FDch%20zbran%ED
54580,25,1319580000,63,63,27,3,156,R,Novela%20z.%20o%20ob%u010Dansk%FDch%20pr%u016Fkazech
54581,25,1319580000,70,65,6,2,143,R,Novela%20z.%20o%20ob%u010Dansk%FDch%20pr%u016Fkazech
54582,25,1319580000,112,12,20,3,147,A,Novela%20z.%20o%20ob%u010Dansk%FDch%20pr%u016Fkazech
54583,25,1319580000,81,64,1,1,147,A,Novela%20z.%20o%20ob%u010Dansk%FDch%20pr%u016Fkazech
54584,26,1319580000,100,2,40,0,142,A,Novela%20z.%20o%20obc%EDch
54585,26,1319580000,88,10,43,2,143,A,Novela%20z.%20o%20obc%EDch
54586,27,1319580000,35,77,33,2,147,R,Novela%20z.%20o%20%FAprav%u011B%20vlastnick%FDch%20vztah%u016F%20k%20p%u016Fd%u011B
54587,27,1319580000,115,0,2,0,117,A,Novela%20z.%20o%20%FAprav%u011B%20vlastnick%FDch%20vztah%u016F%20k%20p%u016Fd%u011B
54588,27,1319580000,81,33,1,3,118,A,Novela%20z.%20o%20%FAprav%u011B%20vlastnick%FDch%20vztah%u016F%20k%20p%u016Fd%u011B
54589,28,1319580000,104,0,18,0,122,A,Novela%20z.%20-%20trestn%ED%20z%E1kon%EDk
54590,28,1319580000,110,0,14,0,124,A,Novela%20z.%20-%20trestn%ED%20z%E1kon%EDk
54591,29,1319580000,102,3,19,1,125,A,Novela%20z.%20o%20provozu%20na%20pozemn%EDch%20komunikac%EDch
54592,29,1319580000,72,31,21,2,126,A,Novela%20z.%20o%20provozu%20na%20pozemn%EDch%20komunikac%EDch
54593,29,1319580000,56,41,26,3,126,R,Novela%20z.%20o%20provozu%20na%20pozemn%EDch%20komunikac%EDch
54594,30,1319580000,100,0,24,0,124,A,Novela%20z.%20-%20%DAstava%20%u010Cesk%E9%20republiky
54595,76,1319666400,35,26,18,3,82,R,P%EDsemn%E1%20interpelace%20I.%20Ohl%EDdala%20na%20J.%20Dobe%u0161e
54596,76,1319666400,37,46,14,0,97,R,P%EDsemn%E1%20interpelace%20I.%20Ohl%EDdala%20na%20J.%20Dobe%u0161e
54597,39,1319666400,114,1,1,1,117,A,Finan%u010Dn%ED%20r%E1mec%20na%20obdob%ED%202014%20-%202020
54598,39,1319666400,72,26,2,17,117,A,Finan%u010Dn%ED%20r%E1mec%20na%20obdob%ED%202014%20-%202020
54599,39,1319666400,73,2,22,19,116,A,Finan%u010Dn%ED%20r%E1mec%20na%20obdob%ED%202014%20-%202020
54600,40,1319666400,88,2,18,5,113,A,Zm%u011Bna%20sm%u011Brnice%202003/96/ES
54601,40,1319666400,77,6,19,11,113,A,Zm%u011Bna%20sm%u011Brnice%202003/96/ES
54602,40,1319666400,66,3,30,14,113,A,Zm%u011Bna%20sm%u011Brnice%202003/96/ES
54603,41,1319666400,85,1,24,0,110,A,Syst%E9m%20vlastn%EDch%20zdroj%u016F%20Evropsk%E9%20unie
54604,41,1319666400,57,22,3,6,88,A,Syst%E9m%20vlastn%EDch%20zdroj%u016F%20Evropsk%E9%20unie
54605,41,1319666400,58,4,18,7,87,A,Syst%E9m%20vlastn%EDch%20zdroj%u016F%20Evropsk%E9%20unie
54606,45,1319666400,82,0,7,0,89,A,Doh.%20mezi%20%u010CR%20a%20Jersey%20o%20v%FDm%u011Bn%u011B%20inf.%20v%20da%u0148.%20z%E1le%u017Eitostech
54607,45,1319666400,82,0,6,1,89,A,Doh.%20mezi%20%u010CR%20a%20Jersey%20o%20v%FDm%u011Bn%u011B%20inf.%20v%20da%u0148.%20z%E1le%u017Eitostech
54608,46,1319666400,84,0,5,0,89,A,Doh.%20mezi%20%u010CR%20a%20vl.%20Bermud%20o%20v%FDm%u011Bn%u011B%20inf.%20v%20da%u0148.%20z%E1le%u017Eitostech
54609,47,1319666400,85,0,6,0,91,A,Sml.%20mezi%20%u010CR%20a%20D%E1nsk%FDm%20kr%E1l.%20o%20zamezen%ED%20dvoj.%20zdan%u011Bn%ED
54610,47,1319666400,88,0,4,0,92,A,Sml.%20mezi%20%u010CR%20a%20D%E1nsk%FDm%20kr%E1l.%20o%20zamezen%ED%20dvoj.%20zdan%u011Bn%ED
54611,48,1319666400,88,0,5,0,93,A,%DAml.%20o%20mezin%E1r.%20ochran%u011B%20dosp%u011Bl%FDch%20osob
54612,0,1319666400,0,0,63,0,63,R,%20
54613,0,1320102000,104,62,11,8,185,A,Po%u0159ad%20sch%u016Fze
54614,0,1320102000,102,80,3,0,185,A,Po%u0159ad%20sch%u016Fze
54615,0,1320102000,103,78,3,1,185,A,Po%u0159ad%20sch%u016Fze
54616,0,1320102000,105,78,1,1,185,A,Po%u0159ad%20sch%u016Fze
54617,0,1320102000,73,100,1,1,175,R,Po%u0159ad%20sch%u016Fze
54618,0,1320102000,71,100,3,1,175,R,Po%u0159ad%20sch%u016Fze
54619,0,1320102000,72,101,1,1,175,R,Po%u0159ad%20sch%u016Fze
54620,0,1320102000,72,100,4,0,176,R,Po%u0159ad%20sch%u016Fze
54621,0,1320102000,74,100,1,1,176,R,Po%u0159ad%20sch%u016Fze
54622,0,1320102000,71,98,7,1,177,R,Po%u0159ad%20sch%u016Fze
54623,0,1320102000,74,99,3,1,177,R,Po%u0159ad%20sch%u016Fze
54624,0,1320102000,73,99,5,1,178,R,Po%u0159ad%20sch%u016Fze
54625,0,1320102000,75,101,1,1,178,R,Po%u0159ad%20sch%u016Fze
54626,0,1320102000,75,101,1,1,178,R,Po%u0159ad%20sch%u016Fze
54627,0,1320102000,74,103,1,1,179,R,Po%u0159ad%20sch%u016Fze
54628,0,1320102000,68,104,6,1,179,R,Po%u0159ad%20sch%u016Fze
54629,0,1320102000,74,102,2,1,179,R,Po%u0159ad%20sch%u016Fze
54630,0,1320102000,72,103,4,1,180,R,Po%u0159ad%20sch%u016Fze
54631,0,1320102000,71,102,6,1,180,R,Po%u0159ad%20sch%u016Fze
54632,0,1320102000,67,100,12,1,180,R,Po%u0159ad%20sch%u016Fze
54633,0,1320102000,74,101,4,1,180,R,Po%u0159ad%20sch%u016Fze
54634,0,1320102000,67,100,12,1,180,R,Po%u0159ad%20sch%u016Fze
54635,0,1320102000,74,98,7,1,180,R,Po%u0159ad%20sch%u016Fze
54636,0,1320102000,74,101,4,1,180,R,Po%u0159ad%20sch%u016Fze
54637,0,1320102000,74,103,2,1,180,R,Po%u0159ad%20sch%u016Fze
54638,0,1320102000,70,99,10,1,180,R,Po%u0159ad%20sch%u016Fze
54639,0,1320102000,74,102,4,1,181,R,Po%u0159ad%20sch%u016Fze
54640,0,1320102000,71,100,9,1,181,R,Po%u0159ad%20sch%u016Fze
54641,0,1320102000,76,101,3,1,181,R,Po%u0159ad%20sch%u016Fze
54642,0,1320102000,76,102,2,1,181,R,Po%u0159ad%20sch%u016Fze
54643,0,1320102000,76,98,6,1,181,R,Po%u0159ad%20sch%u016Fze
54644,0,1320102000,72,100,9,0,181,R,Po%u0159ad%20sch%u016Fze
54645,0,1320102000,74,99,7,1,181,R,Po%u0159ad%20sch%u016Fze
54646,0,1320102000,75,99,6,1,181,R,Po%u0159ad%20sch%u016Fze
54647,0,1320102000,75,101,4,1,181,R,Po%u0159ad%20sch%u016Fze
54648,0,1320102000,74,104,2,1,181,R,Po%u0159ad%20sch%u016Fze
54649,0,1320102000,67,96,17,1,181,R,Po%u0159ad%20sch%u016Fze
54650,0,1320102000,74,93,13,1,181,R,Po%u0159ad%20sch%u016Fze
54651,0,1320102000,71,99,10,1,181,R,Po%u0159ad%20sch%u016Fze
54652,0,1320102000,73,103,2,1,179,R,Po%u0159ad%20sch%u016Fze
54653,0,1320102000,73,101,4,1,179,R,Po%u0159ad%20sch%u016Fze
54654,0,1320102000,74,99,6,1,180,R,Po%u0159ad%20sch%u016Fze
54655,0,1320102000,75,97,7,1,180,R,Po%u0159ad%20sch%u016Fze
54656,0,1320102000,68,103,5,4,180,R,Po%u0159ad%20sch%u016Fze
54657,0,1320102000,65,100,14,1,180,R,Po%u0159ad%20sch%u016Fze
54658,0,1320102000,69,99,11,1,180,R,Po%u0159ad%20sch%u016Fze
54659,0,1320102000,59,99,20,2,180,R,Po%u0159ad%20sch%u016Fze
54660,0,1320102000,71,101,7,1,180,R,Po%u0159ad%20sch%u016Fze
54661,0,1320102000,65,102,11,2,180,R,Po%u0159ad%20sch%u016Fze
54662,0,1320102000,58,103,18,1,180,R,Po%u0159ad%20sch%u016Fze
54663,0,1320102000,56,97,27,1,181,R,Po%u0159ad%20sch%u016Fze
54664,0,1320102000,73,102,5,1,181,R,Po%u0159ad%20sch%u016Fze
54665,0,1320102000,69,92,19,1,181,R,Po%u0159ad%20sch%u016Fze
54666,0,1320102000,63,92,21,2,178,R,Po%u0159ad%20sch%u016Fze
54667,0,1320102000,62,97,19,2,180,R,Po%u0159ad%20sch%u016Fze
54668,0,1320102000,66,99,15,1,181,R,Po%u0159ad%20sch%u016Fze
54669,0,1320102000,66,99,15,1,181,R,Po%u0159ad%20sch%u016Fze
54670,0,1320102000,76,100,4,1,181,R,Po%u0159ad%20sch%u016Fze
54671,0,1320102000,73,100,8,1,182,R,Po%u0159ad%20sch%u016Fze
54672,0,1320102000,69,102,10,1,182,R,Po%u0159ad%20sch%u016Fze
54673,0,1320102000,61,89,31,1,182,R,Po%u0159ad%20sch%u016Fze
54674,0,1320102000,69,101,11,1,182,R,Po%u0159ad%20sch%u016Fze
54675,0,1320102000,63,94,24,1,182,R,Po%u0159ad%20sch%u016Fze
54676,0,1320102000,57,102,22,1,182,R,Po%u0159ad%20sch%u016Fze
54677,0,1320102000,59,100,22,1,182,R,Po%u0159ad%20sch%u016Fze
54678,0,1320102000,64,102,15,1,182,R,Po%u0159ad%20sch%u016Fze
54679,0,1320102000,61,93,27,1,182,R,Po%u0159ad%20sch%u016Fze
54680,0,1320102000,71,101,9,1,182,R,Po%u0159ad%20sch%u016Fze
54681,0,1320102000,67,95,19,1,182,R,Po%u0159ad%20sch%u016Fze
54682,0,1320102000,59,97,25,1,182,R,Po%u0159ad%20sch%u016Fze
54683,0,1320102000,67,92,22,1,182,R,Po%u0159ad%20sch%u016Fze
54684,0,1320102000,65,98,18,1,182,R,Po%u0159ad%20sch%u016Fze
54685,0,1320102000,61,96,24,1,182,R,Po%u0159ad%20sch%u016Fze
54686,0,1320102000,67,99,16,1,183,R,Po%u0159ad%20sch%u016Fze
54687,0,1320102000,70,94,18,1,183,R,Po%u0159ad%20sch%u016Fze
54688,0,1320102000,76,103,3,1,183,R,Po%u0159ad%20sch%u016Fze
54689,0,1320102000,71,97,14,1,183,R,Po%u0159ad%20sch%u016Fze
54690,0,1320102000,60,100,19,3,182,R,Po%u0159ad%20sch%u016Fze
54691,0,1320102000,64,96,22,0,182,R,Po%u0159ad%20sch%u016Fze
54692,0,1320102000,67,101,14,1,183,R,Po%u0159ad%20sch%u016Fze
54693,0,1320102000,59,93,30,1,183,R,Po%u0159ad%20sch%u016Fze
54694,0,1320102000,65,100,17,1,183,R,Po%u0159ad%20sch%u016Fze
54695,0,1320102000,66,93,23,1,183,R,Po%u0159ad%20sch%u016Fze
54696,0,1320102000,66,100,16,1,183,R,Po%u0159ad%20sch%u016Fze
54697,0,1320102000,67,98,17,1,183,R,Po%u0159ad%20sch%u016Fze
54698,0,1320102000,67,101,14,1,183,R,Po%u0159ad%20sch%u016Fze
54699,0,1320102000,65,100,17,1,183,R,Po%u0159ad%20sch%u016Fze
54700,0,1320102000,71,103,8,1,183,R,Po%u0159ad%20sch%u016Fze
54701,0,1320102000,64,95,23,1,183,R,Po%u0159ad%20sch%u016Fze
54702,0,1320102000,66,99,17,1,183,R,Po%u0159ad%20sch%u016Fze
54703,0,1320102000,58,87,37,1,183,R,Po%u0159ad%20sch%u016Fze
54704,0,1320102000,67,102,13,1,183,R,Po%u0159ad%20sch%u016Fze
54705,0,1320102000,62,90,30,1,183,R,Po%u0159ad%20sch%u016Fze
54706,0,1320102000,68,99,15,1,183,R,Po%u0159ad%20sch%u016Fze
54707,0,1320102000,64,101,17,1,183,R,Po%u0159ad%20sch%u016Fze
54708,0,1320102000,67,103,11,2,183,R,Po%u0159ad%20sch%u016Fze
54709,0,1320102000,65,96,21,1,183,R,Po%u0159ad%20sch%u016Fze
54710,0,1320102000,71,98,13,1,183,R,Po%u0159ad%20sch%u016Fze
54711,0,1320102000,65,97,20,1,183,R,Po%u0159ad%20sch%u016Fze
54712,0,1320102000,69,103,11,0,183,R,Po%u0159ad%20sch%u016Fze
54713,0,1320102000,67,98,17,1,183,R,Po%u0159ad%20sch%u016Fze
54714,0,1320102000,68,100,14,1,183,R,Po%u0159ad%20sch%u016Fze
54715,0,1320102000,66,102,14,1,183,R,Po%u0159ad%20sch%u016Fze
54716,0,1320102000,68,96,18,1,183,R,Po%u0159ad%20sch%u016Fze
54717,0,1320102000,68,99,15,1,183,R,Po%u0159ad%20sch%u016Fze
54718,0,1320102000,55,99,28,1,183,R,Po%u0159ad%20sch%u016Fze
54719,0,1320102000,51,95,36,1,183,R,Po%u0159ad%20sch%u016Fze
54720,0,1320102000,59,98,24,2,183,R,Po%u0159ad%20sch%u016Fze
54721,0,1320102000,54,91,34,3,182,R,Po%u0159ad%20sch%u016Fze
54722,0,1320102000,69,98,14,2,183,R,Po%u0159ad%20sch%u016Fze
54723,0,1320102000,69,94,20,1,184,R,Po%u0159ad%20sch%u016Fze
54724,0,1320102000,63,96,24,1,184,R,Po%u0159ad%20sch%u016Fze
54725,0,1320102000,66,99,18,1,184,R,Po%u0159ad%20sch%u016Fze
54726,0,1320102000,62,96,25,1,184,R,Po%u0159ad%20sch%u016Fze
54727,0,1320102000,73,99,11,1,184,R,Po%u0159ad%20sch%u016Fze
54728,0,1320102000,76,98,10,1,185,R,Po%u0159ad%20sch%u016Fze
54729,0,1320102000,70,102,12,1,185,R,Po%u0159ad%20sch%u016Fze
54730,0,1320102000,67,95,21,1,184,R,Po%u0159ad%20sch%u016Fze
54731,0,1320102000,67,91,25,1,184,R,Po%u0159ad%20sch%u016Fze
54732,0,1320102000,68,96,20,0,184,R,Po%u0159ad%20sch%u016Fze
54733,0,1320102000,69,94,20,1,184,R,Po%u0159ad%20sch%u016Fze
54734,0,1320102000,69,94,20,1,184,R,Po%u0159ad%20sch%u016Fze
54735,0,1320102000,68,94,21,1,184,R,Po%u0159ad%20sch%u016Fze
54736,0,1320102000,72,92,19,1,184,R,Po%u0159ad%20sch%u016Fze
54737,0,1320102000,71,97,15,1,184,R,Po%u0159ad%20sch%u016Fze
54738,0,1320102000,72,98,14,1,185,R,Po%u0159ad%20sch%u016Fze
54739,0,1320102000,73,101,11,1,186,R,Po%u0159ad%20sch%u016Fze
54740,0,1320102000,68,98,19,1,186,R,Po%u0159ad%20sch%u016Fze
54741,0,1320102000,69,98,18,1,186,R,Po%u0159ad%20sch%u016Fze
54742,0,1320102000,70,100,15,1,186,R,Po%u0159ad%20sch%u016Fze
54743,0,1320102000,70,99,16,1,186,R,Po%u0159ad%20sch%u016Fze
54744,0,1320102000,72,99,14,1,186,R,Po%u0159ad%20sch%u016Fze
54745,0,1320102000,67,94,25,1,187,R,Po%u0159ad%20sch%u016Fze
54746,0,1320102000,69,100,11,1,181,R,Po%u0159ad%20sch%u016Fze
54747,0,1320102000,75,92,14,1,182,R,Po%u0159ad%20sch%u016Fze
54748,0,1320102000,74,92,16,1,183,R,Po%u0159ad%20sch%u016Fze
54749,0,1320102000,69,98,16,1,184,R,Po%u0159ad%20sch%u016Fze
54750,0,1320102000,73,92,18,1,184,R,Po%u0159ad%20sch%u016Fze
54751,0,1320102000,75,103,5,1,184,R,Po%u0159ad%20sch%u016Fze
54752,0,1320102000,71,103,9,1,184,R,Po%u0159ad%20sch%u016Fze
54753,0,1320102000,74,93,17,1,185,R,Po%u0159ad%20sch%u016Fze
54754,0,1320102000,63,102,16,4,185,R,Po%u0159ad%20sch%u016Fze
54755,0,1320102000,65,100,19,1,185,R,Po%u0159ad%20sch%u016Fze
54756,0,1320102000,74,99,11,1,185,R,Po%u0159ad%20sch%u016Fze
54757,0,1320102000,73,99,11,2,185,R,Po%u0159ad%20sch%u016Fze
54758,0,1320102000,74,101,8,2,185,R,Po%u0159ad%20sch%u016Fze
54759,0,1320102000,70,99,15,1,185,R,Po%u0159ad%20sch%u016Fze
54760,0,1320102000,75,106,0,0,181,R,Po%u0159ad%20sch%u016Fze
54761,0,1320102000,53,101,2,0,156,R,%20
54762,0,1320102000,106,18,19,15,158,A,%20
54763,86,1320102000,89,53,1,0,143,A,Novela%20z.%20o%20stavebn%EDm%20spo%u0159en%ED%20a%20st%E1tn%ED%20podp.%20staveb.%20spo%u0159en%ED
54764,86,1320102000,49,95,1,0,145,R,Novela%20z.%20o%20stavebn%EDm%20spo%u0159en%ED%20a%20st%E1tn%ED%20podp.%20staveb.%20spo%u0159en%ED
54765,86,1320102000,37,95,1,0,133,R,Novela%20z.%20o%20stavebn%EDm%20spo%u0159en%ED%20a%20st%E1tn%ED%20podp.%20staveb.%20spo%u0159en%ED
54766,86,1320188400,40,93,1,0,134,R,Novela%20z.%20o%20stavebn%EDm%20spo%u0159en%ED%20a%20st%E1tn%ED%20podp.%20staveb.%20spo%u0159en%ED
54767,86,1320188400,39,95,9,0,143,R,Novela%20z.%20o%20stavebn%EDm%20spo%u0159en%ED%20a%20st%E1tn%ED%20podp.%20staveb.%20spo%u0159en%ED
54768,86,1320188400,30,82,2,0,114,R,Novela%20z.%20o%20stavebn%EDm%20spo%u0159en%ED%20a%20st%E1tn%ED%20podp.%20staveb.%20spo%u0159en%ED
54769,86,1320188400,28,75,0,0,103,R,Novela%20z.%20o%20stavebn%EDm%20spo%u0159en%ED%20a%20st%E1tn%ED%20podp.%20staveb.%20spo%u0159en%ED
54770,86,1320188400,29,73,0,1,103,R,Novela%20z.%20o%20stavebn%EDm%20spo%u0159en%ED%20a%20st%E1tn%ED%20podp.%20staveb.%20spo%u0159en%ED
54771,86,1320188400,27,72,1,1,101,R,Novela%20z.%20o%20stavebn%EDm%20spo%u0159en%ED%20a%20st%E1tn%ED%20podp.%20staveb.%20spo%u0159en%ED
54772,86,1320188400,30,71,6,1,108,R,Novela%20z.%20o%20stavebn%EDm%20spo%u0159en%ED%20a%20st%E1tn%ED%20podp.%20staveb.%20spo%u0159en%ED
54773,86,1320188400,33,68,7,3,111,R,Novela%20z.%20o%20stavebn%EDm%20spo%u0159en%ED%20a%20st%E1tn%ED%20podp.%20staveb.%20spo%u0159en%ED
54774,86,1320188400,29,70,2,0,101,R,Novela%20z.%20o%20stavebn%EDm%20spo%u0159en%ED%20a%20st%E1tn%ED%20podp.%20staveb.%20spo%u0159en%ED
54775,86,1320188400,27,77,2,0,106,R,Novela%20z.%20o%20stavebn%EDm%20spo%u0159en%ED%20a%20st%E1tn%ED%20podp.%20staveb.%20spo%u0159en%ED
54776,86,1320188400,25,71,3,0,99,R,Novela%20z.%20o%20stavebn%EDm%20spo%u0159en%ED%20a%20st%E1tn%ED%20podp.%20staveb.%20spo%u0159en%ED
54777,86,1320188400,24,72,0,0,96,R,Novela%20z.%20o%20stavebn%EDm%20spo%u0159en%ED%20a%20st%E1tn%ED%20podp.%20staveb.%20spo%u0159en%ED
54778,0,1320188400,90,45,2,2,139,A,Po%u0159ad%20sch%u016Fze
54779,0,1320188400,97,34,17,4,152,A,Po%u0159ad%20sch%u016Fze
54780,0,1320188400,52,98,1,1,152,R,Po%u0159ad%20sch%u016Fze
54781,0,1320188400,50,99,2,1,152,R,Po%u0159ad%20sch%u016Fze
54782,0,1320188400,50,101,2,1,154,R,Po%u0159ad%20sch%u016Fze
54783,0,1320188400,51,100,2,1,154,R,Po%u0159ad%20sch%u016Fze
54784,0,1320188400,51,100,3,1,155,R,Po%u0159ad%20sch%u016Fze
54785,0,1320188400,52,100,2,1,155,R,Po%u0159ad%20sch%u016Fze
54786,0,1320188400,52,102,1,1,156,R,Po%u0159ad%20sch%u016Fze
54787,0,1320188400,51,102,2,1,156,R,Po%u0159ad%20sch%u016Fze
54788,0,1320188400,50,102,3,1,156,R,Po%u0159ad%20sch%u016Fze
54789,0,1320188400,51,100,4,1,156,R,Po%u0159ad%20sch%u016Fze
54790,0,1320188400,52,102,1,1,156,R,Po%u0159ad%20sch%u016Fze
54791,0,1320188400,52,104,2,1,159,R,Po%u0159ad%20sch%u016Fze
54792,0,1320188400,51,104,3,1,159,R,Po%u0159ad%20sch%u016Fze
54793,0,1320188400,50,105,3,1,159,R,Po%u0159ad%20sch%u016Fze
54794,0,1320188400,48,104,6,1,159,R,Po%u0159ad%20sch%u016Fze
54795,1,1320188400,102,67,2,0,171,A,Vl.n.z.%20o%20st%E1tn%EDm%20rozpo%u010Dtu%20%u010CR%20na%20rok%202012
54796,86,1320188400,25,74,0,0,99,R,Novela%20z.%20o%20stavebn%EDm%20spo%u0159en%ED%20a%20st%E1tn%ED%20podp.%20staveb.%20spo%u0159en%ED
54797,86,1320188400,30,69,2,0,101,R,Novela%20z.%20o%20stavebn%EDm%20spo%u0159en%ED%20a%20st%E1tn%ED%20podp.%20staveb.%20spo%u0159en%ED
54798,86,1320188400,13,72,1,0,86,R,Novela%20z.%20o%20stavebn%EDm%20spo%u0159en%ED%20a%20st%E1tn%ED%20podp.%20staveb.%20spo%u0159en%ED
54799,86,1320188400,12,57,25,0,94,R,Novela%20z.%20o%20stavebn%EDm%20spo%u0159en%ED%20a%20st%E1tn%ED%20podp.%20staveb.%20spo%u0159en%ED
54800,86,1320188400,1,34,33,0,68,R,Novela%20z.%20o%20stavebn%EDm%20spo%u0159en%ED%20a%20st%E1tn%ED%20podp.%20staveb.%20spo%u0159en%ED
54801,86,1320188400,13,70,0,0,83,R,Novela%20z.%20o%20stavebn%EDm%20spo%u0159en%ED%20a%20st%E1tn%ED%20podp.%20staveb.%20spo%u0159en%ED
54802,86,1320274800,18,67,0,0,85,R,Novela%20z.%20o%20stavebn%EDm%20spo%u0159en%ED%20a%20st%E1tn%ED%20podp.%20staveb.%20spo%u0159en%ED
54803,86,1320274800,16,68,0,1,85,R,Novela%20z.%20o%20stavebn%EDm%20spo%u0159en%ED%20a%20st%E1tn%ED%20podp.%20staveb.%20spo%u0159en%ED
54804,86,1320274800,17,70,0,1,88,R,Novela%20z.%20o%20stavebn%EDm%20spo%u0159en%ED%20a%20st%E1tn%ED%20podp.%20staveb.%20spo%u0159en%ED
54805,86,1320274800,4,30,51,0,85,R,Novela%20z.%20o%20stavebn%EDm%20spo%u0159en%ED%20a%20st%E1tn%ED%20podp.%20staveb.%20spo%u0159en%ED
54806,86,1320274800,15,69,8,0,92,R,Novela%20z.%20o%20stavebn%EDm%20spo%u0159en%ED%20a%20st%E1tn%ED%20podp.%20staveb.%20spo%u0159en%ED
54807,86,1320274800,2,8,82,0,92,R,Novela%20z.%20o%20stavebn%EDm%20spo%u0159en%ED%20a%20st%E1tn%ED%20podp.%20staveb.%20spo%u0159en%ED
54808,86,1320274800,16,69,0,0,85,R,Novela%20z.%20o%20stavebn%EDm%20spo%u0159en%ED%20a%20st%E1tn%ED%20podp.%20staveb.%20spo%u0159en%ED
54809,86,1320274800,83,0,9,0,92,A,Novela%20z.%20o%20stavebn%EDm%20spo%u0159en%ED%20a%20st%E1tn%ED%20podp.%20staveb.%20spo%u0159en%ED
54810,0,1320274800,79,0,3,0,82,A,%20
54811,0,1320274800,56,77,1,1,135,R,Po%u0159ad%20sch%u016Fze
54812,0,1320274800,93,1,3,0,97,A,%20
54813,0,1320274800,56,77,11,0,144,R,Po%u0159ad%20sch%u016Fze
54814,0,1320274800,72,1,15,1,89,A,%20
54815,0,1320274800,48,67,15,0,130,R,Po%u0159ad%20sch%u016Fze
54816,0,1320274800,95,0,8,0,103,A,%20
54817,0,1320274800,56,78,1,1,136,R,Po%u0159ad%20sch%u016Fze
54818,0,1320274800,98,72,3,0,173,A,%20
54819,86,1320274800,73,108,0,1,182,R,Novela%20z.%20o%20stavebn%EDm%20spo%u0159en%ED%20a%20st%E1tn%ED%20podp.%20staveb.%20spo%u0159en%ED
54820,86,1320274800,109,73,0,0,182,A,Novela%20z.%20o%20stavebn%EDm%20spo%u0159en%ED%20a%20st%E1tn%ED%20podp.%20staveb.%20spo%u0159en%ED
54821,86,1320274800,104,37,40,0,181,A,Novela%20z.%20o%20stavebn%EDm%20spo%u0159en%ED%20a%20st%E1tn%ED%20podp.%20staveb.%20spo%u0159en%ED
54822,0,1320274800,105,73,2,0,180,A,%20
54823,0,1320274800,44,97,0,0,141,R,%20
54824,101,1320274800,100,42,5,0,147,A,Slou%u010Den%E1%20rozprava%20k%20bod%u016Fm%2087%20a%u017E%20100
54825,101,1320274800,97,42,7,0,146,A,Slou%u010Den%E1%20rozprava%20k%20bod%u016Fm%2087%20a%u017E%20100
54826,0,1320274800,133,6,1,1,141,A,%20
54827,0,1320361200,121,0,16,0,137,A,%20
54828,0,1320361200,72,98,1,1,172,R,Po%u0159ad%20sch%u016Fze
54829,0,1320361200,97,68,6,1,172,A,Po%u0159ad%20sch%u016Fze
54830,1,1320361200,169,0,16,0,185,A,Novela%20z.%20o%20ve%u0159ejn%FDch%20zak%E1zk%E1ch
54831,1,1320361200,174,0,11,0,185,A,Novela%20z.%20o%20ve%u0159ejn%FDch%20zak%E1zk%E1ch
54832,1,1320361200,176,0,9,0,185,A,Novela%20z.%20o%20ve%u0159ejn%FDch%20zak%E1zk%E1ch
54833,1,1320361200,103,75,6,1,185,A,Novela%20z.%20o%20ve%u0159ejn%FDch%20zak%E1zk%E1ch
54834,1,1320361200,106,72,6,1,185,A,Novela%20z.%20o%20ve%u0159ejn%FDch%20zak%E1zk%E1ch
54835,1,1320361200,144,31,9,1,185,A,Novela%20z.%20o%20ve%u0159ejn%FDch%20zak%E1zk%E1ch
54836,1,1320361200,77,101,7,0,185,R,Novela%20z.%20o%20ve%u0159ejn%FDch%20zak%E1zk%E1ch
54837,1,1320361200,177,0,8,0,185,A,Novela%20z.%20o%20ve%u0159ejn%FDch%20zak%E1zk%E1ch
54838,1,1320361200,178,0,8,0,186,A,Novela%20z.%20o%20ve%u0159ejn%FDch%20zak%E1zk%E1ch
54839,1,1320361200,180,0,6,0,186,A,Novela%20z.%20o%20ve%u0159ejn%FDch%20zak%E1zk%E1ch
54840,1,1320361200,154,1,24,7,186,A,Novela%20z.%20o%20ve%u0159ejn%FDch%20zak%E1zk%E1ch
54841,1,1320361200,182,0,4,0,186,A,Novela%20z.%20o%20ve%u0159ejn%FDch%20zak%E1zk%E1ch
54842,1,1320361200,177,1,7,1,186,A,Novela%20z.%20o%20ve%u0159ejn%FDch%20zak%E1zk%E1ch
54843,1,1320361200,179,1,5,0,185,A,Novela%20z.%20o%20ve%u0159ejn%FDch%20zak%E1zk%E1ch
54844,1,1320361200,181,0,4,0,185,A,Novela%20z.%20o%20ve%u0159ejn%FDch%20zak%E1zk%E1ch
54845,1,1320361200,106,64,13,2,185,A,Novela%20z.%20o%20ve%u0159ejn%FDch%20zak%E1zk%E1ch
54846,1,1320361200,152,9,21,3,185,A,Novela%20z.%20o%20ve%u0159ejn%FDch%20zak%E1zk%E1ch
54847,1,1320361200,90,73,13,8,184,R,Novela%20z.%20o%20ve%u0159ejn%FDch%20zak%E1zk%E1ch
54848,1,1320361200,178,1,6,0,185,A,Novela%20z.%20o%20ve%u0159ejn%FDch%20zak%E1zk%E1ch
54849,1,1320361200,101,36,5,33,175,A,Novela%20z.%20o%20ve%u0159ejn%FDch%20zak%E1zk%E1ch
54850,0,1320361200,92,35,14,7,148,A,%20
54851,0,1320361200,97,49,3,0,149,A,%20
54852,0,1320361200,40,85,1,1,127,R,Po%u0159ad%20sch%u016Fze
54853,0,1320361200,49,90,0,0,139,R,Po%u0159ad%20sch%u016Fze
54854,0,1320361200,48,89,2,0,139,R,Po%u0159ad%20sch%u016Fze
54855,0,1320361200,48,90,1,0,139,R,Po%u0159ad%20sch%u016Fze
54856,0,1320361200,49,89,1,0,139,R,Po%u0159ad%20sch%u016Fze
54857,0,1320361200,49,90,0,0,139,R,Po%u0159ad%20sch%u016Fze
54858,0,1320361200,49,89,1,0,139,R,Po%u0159ad%20sch%u016Fze
54859,0,1320361200,48,92,2,0,142,R,Po%u0159ad%20sch%u016Fze
54860,0,1320361200,48,92,3,0,143,R,Po%u0159ad%20sch%u016Fze
54861,0,1320361200,48,92,3,0,143,R,Po%u0159ad%20sch%u016Fze
54862,101,1320361200,25,87,0,0,112,R,Slou%u010Den%E1%20rozprava%20k%20bod%u016Fm%2087%20a%u017E%20100
54863,101,1320447600,5,1,105,0,111,R,Slou%u010Den%E1%20rozprava%20k%20bod%u016Fm%2087%20a%u017E%20100
54864,101,1320447600,92,7,4,2,105,A,Slou%u010Den%E1%20rozprava%20k%20bod%u016Fm%2087%20a%u017E%20100
54865,101,1320447600,71,39,3,0,113,A,Slou%u010Den%E1%20rozprava%20k%20bod%u016Fm%2087%20a%u017E%20100
54866,101,1320447600,40,69,15,2,126,R,Slou%u010Den%E1%20rozprava%20k%20bod%u016Fm%2087%20a%u017E%20100
54867,101,1320447600,34,66,25,0,125,R,Slou%u010Den%E1%20rozprava%20k%20bod%u016Fm%2087%20a%u017E%20100
54868,101,1320447600,17,14,59,6,96,R,Slou%u010Den%E1%20rozprava%20k%20bod%u016Fm%2087%20a%u017E%20100
54869,101,1320534000,79,3,0,0,82,A,Slou%u010Den%E1%20rozprava%20k%20bod%u016Fm%2087%20a%u017E%20100
54870,101,1320534000,62,27,12,0,101,A,Slou%u010Den%E1%20rozprava%20k%20bod%u016Fm%2087%20a%u017E%20100
54871,101,1320534000,43,70,8,0,121,R,Slou%u010Den%E1%20rozprava%20k%20bod%u016Fm%2087%20a%u017E%20100
54872,101,1320534000,41,66,2,1,110,R,Slou%u010Den%E1%20rozprava%20k%20bod%u016Fm%2087%20a%u017E%20100
54873,101,1320534000,39,67,7,0,113,R,Slou%u010Den%E1%20rozprava%20k%20bod%u016Fm%2087%20a%u017E%20100
54874,101,1320534000,41,70,3,0,114,R,Slou%u010Den%E1%20rozprava%20k%20bod%u016Fm%2087%20a%u017E%20100
54875,101,1320534000,41,71,2,0,114,R,Slou%u010Den%E1%20rozprava%20k%20bod%u016Fm%2087%20a%u017E%20100
54876,101,1320534000,41,72,2,0,115,R,Slou%u010Den%E1%20rozprava%20k%20bod%u016Fm%2087%20a%u017E%20100
54877,101,1320534000,43,68,1,0,112,R,Slou%u010Den%E1%20rozprava%20k%20bod%u016Fm%2087%20a%u017E%20100
54878,101,1320534000,41,68,2,0,111,R,Slou%u010Den%E1%20rozprava%20k%20bod%u016Fm%2087%20a%u017E%20100
54879,101,1320534000,47,70,5,0,122,R,Slou%u010Den%E1%20rozprava%20k%20bod%u016Fm%2087%20a%u017E%20100
54880,101,1320534000,43,73,7,0,123,R,Slou%u010Den%E1%20rozprava%20k%20bod%u016Fm%2087%20a%u017E%20100
54881,101,1320534000,36,59,34,0,129,R,Slou%u010Den%E1%20rozprava%20k%20bod%u016Fm%2087%20a%u017E%20100
54882,101,1320534000,39,59,2,1,101,R,Slou%u010Den%E1%20rozprava%20k%20bod%u016Fm%2087%20a%u017E%20100
54883,101,1320534000,48,74,2,0,124,R,Slou%u010Den%E1%20rozprava%20k%20bod%u016Fm%2087%20a%u017E%20100
54884,101,1320534000,49,75,4,0,128,R,Slou%u010Den%E1%20rozprava%20k%20bod%u016Fm%2087%20a%u017E%20100
54885,101,1320534000,48,75,5,0,128,R,Slou%u010Den%E1%20rozprava%20k%20bod%u016Fm%2087%20a%u017E%20100
54886,101,1320534000,49,76,3,0,128,R,Slou%u010Den%E1%20rozprava%20k%20bod%u016Fm%2087%20a%u017E%20100
54887,101,1320534000,43,90,18,0,151,R,Slou%u010Den%E1%20rozprava%20k%20bod%u016Fm%2087%20a%u017E%20100
54888,101,1320534000,44,82,28,0,154,R,Slou%u010Den%E1%20rozprava%20k%20bod%u016Fm%2087%20a%u017E%20100
54889,101,1320534000,42,78,36,0,156,R,Slou%u010Den%E1%20rozprava%20k%20bod%u016Fm%2087%20a%u017E%20100
54890,101,1320534000,46,80,30,0,156,R,Slou%u010Den%E1%20rozprava%20k%20bod%u016Fm%2087%20a%u017E%20100
54891,101,1320534000,44,83,28,0,155,R,Slou%u010Den%E1%20rozprava%20k%20bod%u016Fm%2087%20a%u017E%20100
54892,101,1320534000,41,78,37,0,156,R,Slou%u010Den%E1%20rozprava%20k%20bod%u016Fm%2087%20a%u017E%20100
54893,101,1320534000,48,78,1,0,127,R,Slou%u010Den%E1%20rozprava%20k%20bod%u016Fm%2087%20a%u017E%20100
54894,101,1320534000,47,81,2,0,130,R,Slou%u010Den%E1%20rozprava%20k%20bod%u016Fm%2087%20a%u017E%20100
54895,101,1320534000,49,81,2,0,132,R,Slou%u010Den%E1%20rozprava%20k%20bod%u016Fm%2087%20a%u017E%20100
54896,101,1320534000,52,81,17,0,150,R,Slou%u010Den%E1%20rozprava%20k%20bod%u016Fm%2087%20a%u017E%20100
54897,101,1320534000,54,85,12,0,151,R,Slou%u010Den%E1%20rozprava%20k%20bod%u016Fm%2087%20a%u017E%20100
54898,87,1320534000,71,107,2,1,181,R,Vl.n.z.%20o%20zdravotnick%E9%20z%E1chrann%E9%20slu%u017Eb%u011B
54899,87,1320534000,109,51,16,5,181,A,Vl.n.z.%20o%20zdravotnick%E9%20z%E1chrann%E9%20slu%u017Eb%u011B
54900,88,1320534000,49,108,19,4,180,R,Vl.n.z.%20o%20Gener%E1ln%ED%20inspekci%20bezpe%u010Dnostn%EDch%20sbor%u016F
54901,88,1320534000,108,69,2,1,180,A,Vl.n.z.%20o%20Gener%E1ln%ED%20inspekci%20bezpe%u010Dnostn%EDch%20sbor%u016F
54902,89,1320534000,107,69,1,0,177,A,Vl.n.z.%20v%20souvislosti%20s%20%FAsporn%FDmi%20opat%u0159en%EDmi%20v%20p%u016Fsob.%20MPSV
54903,89,1320534000,169,6,1,3,179,A,Vl.n.z.%20v%20souvislosti%20s%20%FAsporn%FDmi%20opat%u0159en%EDmi%20v%20p%u016Fsob.%20MPSV
54904,89,1320534000,108,70,0,0,178,A,Vl.n.z.%20v%20souvislosti%20s%20%FAsporn%FDmi%20opat%u0159en%EDmi%20v%20p%u016Fsob.%20MPSV
54905,90,1320534000,109,70,0,0,179,A,Novela%20z.%20o%20pomoci%20v%20hmotn%E9%20nouzi
54906,91,1320534000,108,69,2,0,179,A,Novela%20z.%20o%20zam%u011Bstnanosti
54907,92,1320534000,110,70,0,0,180,A,Novela%20z.%20o%20dani%20z%20p%u0159idan%E9%20hodnoty%20-%20EU
54908,93,1320534000,110,70,0,0,180,A,Vl.n.z.%20o%20zdravotn%EDch%20slu%u017Eb%E1ch%20-%20EU
54909,94,1320534000,107,70,0,1,178,A,Vl.n.z.%20o%20specifick%FDch%20zdravotn%EDch%20slu%u017Eb%E1ch%20-%20EU
54910,95,1320534000,109,70,0,0,179,A,Vl.n.z.v%20souvislosti%20s%20p%u0159ijet%EDm%20z%E1kon%u016F%20o%20zdrav.%20slu%u017Eb%E1ch
54911,96,1320534000,110,70,0,0,180,A,Novela%20z.%20o%20ve%u0159ejn%E9m%20zdravotn%EDm%20poji%u0161t%u011Bn%ED
54912,97,1320534000,109,70,1,0,180,A,Novela%20z.%20-%20z%E1kon%EDk%20pr%E1ce%20-%20EU
54913,98,1320534000,109,70,0,0,179,A,Vl.n.z.%20o%20d%u016Fchodov%E9m%20spo%u0159en%ED%20-%20EU
54914,99,1320534000,109,70,0,0,179,A,Vl.n.z.%20o%20dopl%u0148kov%E9m%20penzijn%EDm%20spo%u0159en%ED%20-%20EU
54915,100,1320534000,107,70,0,0,177,A,Vl.n.z.%20v%20souvislosti%20s%20p%u0159ij.%20z.%20o%20d%u016Fch.%20a%20pen.%20spo%u0159en%ED%20-%20EU
54916,3,1320793200,140,5,20,5,170,A,Vl.n.z.%20o%20podporovan%FDch%20zdroj%EDch%20energie%20-%20EU
54917,3,1320793200,169,1,0,0,170,A,Vl.n.z.%20o%20podporovan%FDch%20zdroj%EDch%20energie%20-%20EU
54918,3,1320793200,169,1,1,1,172,A,Vl.n.z.%20o%20podporovan%FDch%20zdroj%EDch%20energie%20-%20EU
54919,3,1320793200,169,1,1,1,172,A,Vl.n.z.%20o%20podporovan%FDch%20zdroj%EDch%20energie%20-%20EU
54920,3,1320793200,164,3,3,2,172,A,Vl.n.z.%20o%20podporovan%FDch%20zdroj%EDch%20energie%20-%20EU
54921,3,1320793200,168,2,2,0,172,A,Vl.n.z.%20o%20podporovan%FDch%20zdroj%EDch%20energie%20-%20EU
54922,3,1320793200,165,2,4,1,172,A,Vl.n.z.%20o%20podporovan%FDch%20zdroj%EDch%20energie%20-%20EU
54923,3,1320793200,16,60,70,26,172,R,Vl.n.z.%20o%20podporovan%FDch%20zdroj%EDch%20energie%20-%20EU
54924,3,1320793200,114,25,17,16,172,A,Vl.n.z.%20o%20podporovan%FDch%20zdroj%EDch%20energie%20-%20EU
54925,3,1320793200,133,30,6,3,172,A,Vl.n.z.%20o%20podporovan%FDch%20zdroj%EDch%20energie%20-%20EU
54926,3,1320793200,146,15,7,5,173,A,Vl.n.z.%20o%20podporovan%FDch%20zdroj%EDch%20energie%20-%20EU
54927,3,1320793200,149,16,4,4,173,A,Vl.n.z.%20o%20podporovan%FDch%20zdroj%EDch%20energie%20-%20EU
54928,3,1320793200,151,11,6,5,173,A,Vl.n.z.%20o%20podporovan%FDch%20zdroj%EDch%20energie%20-%20EU
54929,3,1320793200,137,20,9,7,173,A,Vl.n.z.%20o%20podporovan%FDch%20zdroj%EDch%20energie%20-%20EU
54930,3,1320793200,145,14,11,3,173,A,Vl.n.z.%20o%20podporovan%FDch%20zdroj%EDch%20energie%20-%20EU
54931,3,1320793200,151,12,6,4,173,A,Vl.n.z.%20o%20podporovan%FDch%20zdroj%EDch%20energie%20-%20EU
54932,3,1320793200,150,14,4,5,173,A,Vl.n.z.%20o%20podporovan%FDch%20zdroj%EDch%20energie%20-%20EU
54933,3,1320793200,150,12,7,4,173,A,Vl.n.z.%20o%20podporovan%FDch%20zdroj%EDch%20energie%20-%20EU
54934,3,1320793200,151,10,5,7,173,A,Vl.n.z.%20o%20podporovan%FDch%20zdroj%EDch%20energie%20-%20EU
54935,3,1320793200,57,97,10,8,172,R,Vl.n.z.%20o%20podporovan%FDch%20zdroj%EDch%20energie%20-%20EU
54936,3,1320793200,150,7,12,3,172,A,Vl.n.z.%20o%20podporovan%FDch%20zdroj%EDch%20energie%20-%20EU
54937,3,1320793200,129,20,15,8,172,A,Vl.n.z.%20o%20podporovan%FDch%20zdroj%EDch%20energie%20-%20EU
54938,3,1320793200,112,27,14,18,171,A,Vl.n.z.%20o%20podporovan%FDch%20zdroj%EDch%20energie%20-%20EU
54939,0,1320793200,97,23,30,20,170,A,%20
54940,4,1320793200,156,1,14,2,173,A,Novela%20z.%20o%20zam%u011Bstnanosti%20-%20EU
54941,4,1320793200,160,0,12,0,172,A,Novela%20z.%20o%20zam%u011Bstnanosti%20-%20EU
54942,5,1320793200,37,92,6,14,149,R,Vl.n.z.%20-%20ob%u010Dansk%FD%20z%E1kon%EDk%20-%20EU
54943,5,1320793200,61,86,0,1,148,R,Vl.n.z.%20-%20ob%u010Dansk%FD%20z%E1kon%EDk%20-%20EU
54944,5,1320793200,145,1,2,1,149,A,Vl.n.z.%20-%20ob%u010Dansk%FD%20z%E1kon%EDk%20-%20EU
54945,5,1320793200,11,56,69,14,150,R,Vl.n.z.%20-%20ob%u010Dansk%FD%20z%E1kon%EDk%20-%20EU
54946,5,1320793200,104,22,14,10,150,A,Vl.n.z.%20-%20ob%u010Dansk%FD%20z%E1kon%EDk%20-%20EU
54947,5,1320793200,110,26,10,6,152,A,Vl.n.z.%20-%20ob%u010Dansk%FD%20z%E1kon%EDk%20-%20EU
54948,5,1320793200,38,99,9,6,152,R,Vl.n.z.%20-%20ob%u010Dansk%FD%20z%E1kon%EDk%20-%20EU
54949,5,1320793200,58,87,5,2,152,R,Vl.n.z.%20-%20ob%u010Dansk%FD%20z%E1kon%EDk%20-%20EU
54950,5,1320793200,59,86,3,4,152,R,Vl.n.z.%20-%20ob%u010Dansk%FD%20z%E1kon%EDk%20-%20EU
54951,5,1320793200,26,103,7,16,152,R,Vl.n.z.%20-%20ob%u010Dansk%FD%20z%E1kon%EDk%20-%20EU
54952,5,1320793200,59,90,2,1,152,R,Vl.n.z.%20-%20ob%u010Dansk%FD%20z%E1kon%EDk%20-%20EU
54953,5,1320793200,58,92,1,2,153,R,Vl.n.z.%20-%20ob%u010Dansk%FD%20z%E1kon%EDk%20-%20EU
54954,5,1320793200,60,89,4,0,153,R,Vl.n.z.%20-%20ob%u010Dansk%FD%20z%E1kon%EDk%20-%20EU
54955,5,1320793200,60,90,2,1,153,R,Vl.n.z.%20-%20ob%u010Dansk%FD%20z%E1kon%EDk%20-%20EU
54956,5,1320793200,147,4,1,1,153,A,Vl.n.z.%20-%20ob%u010Dansk%FD%20z%E1kon%EDk%20-%20EU
54957,5,1320793200,60,90,3,0,153,R,Vl.n.z.%20-%20ob%u010Dansk%FD%20z%E1kon%EDk%20-%20EU
54958,5,1320793200,59,91,3,0,153,R,Vl.n.z.%20-%20ob%u010Dansk%FD%20z%E1kon%EDk%20-%20EU
54959,5,1320793200,57,90,5,1,153,R,Vl.n.z.%20-%20ob%u010Dansk%FD%20z%E1kon%EDk%20-%20EU
54960,5,1320793200,60,89,4,0,153,R,Vl.n.z.%20-%20ob%u010Dansk%FD%20z%E1kon%EDk%20-%20EU
54961,5,1320793200,58,93,2,0,153,R,Vl.n.z.%20-%20ob%u010Dansk%FD%20z%E1kon%EDk%20-%20EU
54962,5,1320793200,60,90,3,0,153,R,Vl.n.z.%20-%20ob%u010Dansk%FD%20z%E1kon%EDk%20-%20EU
54963,5,1320793200,59,92,2,0,153,R,Vl.n.z.%20-%20ob%u010Dansk%FD%20z%E1kon%EDk%20-%20EU
54964,5,1320793200,58,93,2,1,154,R,Vl.n.z.%20-%20ob%u010Dansk%FD%20z%E1kon%EDk%20-%20EU
54965,5,1320793200,59,92,2,1,154,R,Vl.n.z.%20-%20ob%u010Dansk%FD%20z%E1kon%EDk%20-%20EU
54966,5,1320793200,60,93,1,0,154,R,Vl.n.z.%20-%20ob%u010Dansk%FD%20z%E1kon%EDk%20-%20EU
54967,5,1320793200,59,90,3,2,154,R,Vl.n.z.%20-%20ob%u010Dansk%FD%20z%E1kon%EDk%20-%20EU
54968,5,1320793200,62,77,14,2,155,R,Vl.n.z.%20-%20ob%u010Dansk%FD%20z%E1kon%EDk%20-%20EU
54969,5,1320793200,60,90,4,1,155,R,Vl.n.z.%20-%20ob%u010Dansk%FD%20z%E1kon%EDk%20-%20EU
54970,5,1320793200,59,89,5,2,155,R,Vl.n.z.%20-%20ob%u010Dansk%FD%20z%E1kon%EDk%20-%20EU
54971,5,1320793200,62,91,1,1,155,R,Vl.n.z.%20-%20ob%u010Dansk%FD%20z%E1kon%EDk%20-%20EU
54972,5,1320793200,57,82,9,6,154,R,Vl.n.z.%20-%20ob%u010Dansk%FD%20z%E1kon%EDk%20-%20EU
54973,5,1320793200,53,81,17,4,155,R,Vl.n.z.%20-%20ob%u010Dansk%FD%20z%E1kon%EDk%20-%20EU
54974,5,1320793200,64,76,6,7,153,R,Vl.n.z.%20-%20ob%u010Dansk%FD%20z%E1kon%EDk%20-%20EU
54975,5,1320793200,1,127,24,3,155,R,Vl.n.z.%20-%20ob%u010Dansk%FD%20z%E1kon%EDk%20-%20EU
54976,5,1320793200,142,2,9,2,155,A,Vl.n.z.%20-%20ob%u010Dansk%FD%20z%E1kon%EDk%20-%20EU
54977,5,1320793200,92,35,5,22,154,A,Vl.n.z.%20-%20ob%u010Dansk%FD%20z%E1kon%EDk%20-%20EU
54978,6,1320793200,95,3,1,5,104,A,Vl.n.z.%20o%20mezin%E1rodn%EDm%20pr%E1vu%20soukrom%E9m%20-%20EU
54979,6,1320793200,104,0,1,2,107,A,Vl.n.z.%20o%20mezin%E1rodn%EDm%20pr%E1vu%20soukrom%E9m%20-%20EU
54980,6,1320793200,109,0,0,2,111,A,Vl.n.z.%20o%20mezin%E1rodn%EDm%20pr%E1vu%20soukrom%E9m%20-%20EU
54981,7,1320793200,102,4,13,13,132,A,Novela%20z.%20o%20rozhod%u010D%EDm%20%u0159%EDzen%ED
54982,7,1320793200,126,0,10,0,136,A,Novela%20z.%20o%20rozhod%u010D%EDm%20%u0159%EDzen%ED
54983,7,1320793200,96,10,27,3,136,A,Novela%20z.%20o%20rozhod%u010D%EDm%20%u0159%EDzen%ED
54984,7,1320793200,50,75,12,0,137,R,Novela%20z.%20o%20rozhod%u010D%EDm%20%u0159%EDzen%ED
54985,7,1320793200,134,1,6,0,141,A,Novela%20z.%20o%20rozhod%u010D%EDm%20%u0159%EDzen%ED
54986,8,1320793200,66,39,23,12,140,R,Vl.n.z.o%20mezin%E1rodn%ED%20pomoci%20p%u0159i%20vym%E1h%E1n%ED%20fin.pohled%E1vek%20-%20EU
54987,8,1320793200,34,59,19,27,139,R,Vl.n.z.o%20mezin%E1rodn%ED%20pomoci%20p%u0159i%20vym%E1h%E1n%ED%20fin.pohled%E1vek%20-%20EU
54988,8,1320793200,99,5,19,17,140,A,Vl.n.z.o%20mezin%E1rodn%ED%20pomoci%20p%u0159i%20vym%E1h%E1n%ED%20fin.pohled%E1vek%20-%20EU
54989,8,1320793200,29,2,105,4,140,R,Vl.n.z.o%20mezin%E1rodn%ED%20pomoci%20p%u0159i%20vym%E1h%E1n%ED%20fin.pohled%E1vek%20-%20EU
54990,8,1320793200,28,55,28,30,141,R,Vl.n.z.o%20mezin%E1rodn%ED%20pomoci%20p%u0159i%20vym%E1h%E1n%ED%20fin.pohled%E1vek%20-%20EU
54991,8,1320793200,113,2,19,6,140,A,Vl.n.z.o%20mezin%E1rodn%ED%20pomoci%20p%u0159i%20vym%E1h%E1n%ED%20fin.pohled%E1vek%20-%20EU
54992,8,1320793200,111,1,21,8,141,A,Vl.n.z.o%20mezin%E1rodn%ED%20pomoci%20p%u0159i%20vym%E1h%E1n%ED%20fin.pohled%E1vek%20-%20EU
54993,8,1320793200,120,1,17,4,142,A,Vl.n.z.o%20mezin%E1rodn%ED%20pomoci%20p%u0159i%20vym%E1h%E1n%ED%20fin.pohled%E1vek%20-%20EU
54994,8,1320793200,130,0,10,2,142,A,Vl.n.z.o%20mezin%E1rodn%ED%20pomoci%20p%u0159i%20vym%E1h%E1n%ED%20fin.pohled%E1vek%20-%20EU
54995,9,1320793200,127,0,16,1,144,A,Novela%20z.%20o%20vzd%u011Bl%E1v%E1n%ED%20-%20%u0161kolsk%FD%20z%E1kon
54996,9,1320793200,136,0,8,1,145,A,Novela%20z.%20o%20vzd%u011Bl%E1v%E1n%ED%20-%20%u0161kolsk%FD%20z%E1kon
54997,9,1320793200,25,112,8,1,146,R,Novela%20z.%20o%20vzd%u011Bl%E1v%E1n%ED%20-%20%u0161kolsk%FD%20z%E1kon
54998,9,1320793200,27,110,9,1,147,R,Novela%20z.%20o%20vzd%u011Bl%E1v%E1n%ED%20-%20%u0161kolsk%FD%20z%E1kon
54999,9,1320793200,25,115,8,1,149,R,Novela%20z.%20o%20vzd%u011Bl%E1v%E1n%ED%20-%20%u0161kolsk%FD%20z%E1kon
55000,9,1320793200,135,2,11,2,150,A,Novela%20z.%20o%20vzd%u011Bl%E1v%E1n%ED%20-%20%u0161kolsk%FD%20z%E1kon
55001,9,1320793200,9,131,9,2,151,R,Novela%20z.%20o%20vzd%u011Bl%E1v%E1n%ED%20-%20%u0161kolsk%FD%20z%E1kon
55002,9,1320793200,4,138,8,1,151,R,Novela%20z.%20o%20vzd%u011Bl%E1v%E1n%ED%20-%20%u0161kolsk%FD%20z%E1kon
55003,9,1320793200,24,111,12,6,153,R,Novela%20z.%20o%20vzd%u011Bl%E1v%E1n%ED%20-%20%u0161kolsk%FD%20z%E1kon
55004,9,1320793200,19,124,10,0,153,R,Novela%20z.%20o%20vzd%u011Bl%E1v%E1n%ED%20-%20%u0161kolsk%FD%20z%E1kon
55005,9,1320793200,15,117,17,4,153,R,Novela%20z.%20o%20vzd%u011Bl%E1v%E1n%ED%20-%20%u0161kolsk%FD%20z%E1kon
55006,9,1320793200,13,123,14,3,153,R,Novela%20z.%20o%20vzd%u011Bl%E1v%E1n%ED%20-%20%u0161kolsk%FD%20z%E1kon
55007,9,1320793200,32,94,18,9,153,R,Novela%20z.%20o%20vzd%u011Bl%E1v%E1n%ED%20-%20%u0161kolsk%FD%20z%E1kon
55008,9,1320793200,89,43,19,4,155,A,Novela%20z.%20o%20vzd%u011Bl%E1v%E1n%ED%20-%20%u0161kolsk%FD%20z%E1kon
55009,9,1320793200,61,78,11,5,155,R,Novela%20z.%20o%20vzd%u011Bl%E1v%E1n%ED%20-%20%u0161kolsk%FD%20z%E1kon
55010,9,1320793200,24,116,9,6,155,R,Novela%20z.%20o%20vzd%u011Bl%E1v%E1n%ED%20-%20%u0161kolsk%FD%20z%E1kon
55011,9,1320793200,10,132,11,2,155,R,Novela%20z.%20o%20vzd%u011Bl%E1v%E1n%ED%20-%20%u0161kolsk%FD%20z%E1kon
55012,9,1320793200,33,109,11,2,155,R,Novela%20z.%20o%20vzd%u011Bl%E1v%E1n%ED%20-%20%u0161kolsk%FD%20z%E1kon
55013,9,1320793200,145,4,6,0,155,A,Novela%20z.%20o%20vzd%u011Bl%E1v%E1n%ED%20-%20%u0161kolsk%FD%20z%E1kon
55014,9,1320793200,24,123,8,0,155,R,Novela%20z.%20o%20vzd%u011Bl%E1v%E1n%ED%20-%20%u0161kolsk%FD%20z%E1kon
55015,9,1320793200,17,123,9,6,155,R,Novela%20z.%20o%20vzd%u011Bl%E1v%E1n%ED%20-%20%u0161kolsk%FD%20z%E1kon
55016,9,1320793200,69,56,26,4,155,R,Novela%20z.%20o%20vzd%u011Bl%E1v%E1n%ED%20-%20%u0161kolsk%FD%20z%E1kon
55017,9,1320793200,35,111,7,1,154,R,Novela%20z.%20o%20vzd%u011Bl%E1v%E1n%ED%20-%20%u0161kolsk%FD%20z%E1kon
55018,9,1320793200,35,109,10,0,154,R,Novela%20z.%20o%20vzd%u011Bl%E1v%E1n%ED%20-%20%u0161kolsk%FD%20z%E1kon
55019,9,1320793200,28,116,8,2,154,R,Novela%20z.%20o%20vzd%u011Bl%E1v%E1n%ED%20-%20%u0161kolsk%FD%20z%E1kon
55020,9,1320793200,35,111,8,0,154,R,Novela%20z.%20o%20vzd%u011Bl%E1v%E1n%ED%20-%20%u0161kolsk%FD%20z%E1kon
55021,9,1320793200,33,111,9,1,154,R,Novela%20z.%20o%20vzd%u011Bl%E1v%E1n%ED%20-%20%u0161kolsk%FD%20z%E1kon
55022,9,1320793200,33,109,11,1,154,R,Novela%20z.%20o%20vzd%u011Bl%E1v%E1n%ED%20-%20%u0161kolsk%FD%20z%E1kon
55023,9,1320793200,34,111,8,1,154,R,Novela%20z.%20o%20vzd%u011Bl%E1v%E1n%ED%20-%20%u0161kolsk%FD%20z%E1kon
55024,9,1320793200,32,107,13,2,154,R,Novela%20z.%20o%20vzd%u011Bl%E1v%E1n%ED%20-%20%u0161kolsk%FD%20z%E1kon
55025,9,1320793200,15,126,11,2,154,R,Novela%20z.%20o%20vzd%u011Bl%E1v%E1n%ED%20-%20%u0161kolsk%FD%20z%E1kon
55026,9,1320793200,81,55,15,3,154,A,Novela%20z.%20o%20vzd%u011Bl%E1v%E1n%ED%20-%20%u0161kolsk%FD%20z%E1kon
55027,9,1320793200,83,58,13,1,155,A,Novela%20z.%20o%20vzd%u011Bl%E1v%E1n%ED%20-%20%u0161kolsk%FD%20z%E1kon
55028,9,1320793200,134,8,9,2,153,A,Novela%20z.%20o%20vzd%u011Bl%E1v%E1n%ED%20-%20%u0161kolsk%FD%20z%E1kon
55029,9,1320793200,145,0,6,3,154,A,Novela%20z.%20o%20vzd%u011Bl%E1v%E1n%ED%20-%20%u0161kolsk%FD%20z%E1kon
55030,10,1320793200,105,0,44,0,149,A,Novela%20z.o%20podpo%u0159e%20v%FDzkumu%2Cexperiment%E1ln%EDho%20v%FDvoje%20a%20inovac%ED
55031,10,1320793200,115,2,32,0,149,A,Novela%20z.o%20podpo%u0159e%20v%FDzkumu%2Cexperiment%E1ln%EDho%20v%FDvoje%20a%20inovac%ED
55032,10,1320793200,114,0,36,0,150,A,Novela%20z.o%20podpo%u0159e%20v%FDzkumu%2Cexperiment%E1ln%EDho%20v%FDvoje%20a%20inovac%ED
55033,10,1320793200,121,3,26,0,150,A,Novela%20z.o%20podpo%u0159e%20v%FDzkumu%2Cexperiment%E1ln%EDho%20v%FDvoje%20a%20inovac%ED
55034,11,1320793200,55,77,21,0,153,R,Novela%20z.%20o%20zru%u0161en%ED%20Fondu%20n%E1rodn%EDho%20majetku
55035,11,1320793200,142,1,12,0,155,A,Novela%20z.%20o%20zru%u0161en%ED%20Fondu%20n%E1rodn%EDho%20majetku
55036,11,1320793200,105,16,16,18,155,A,Novela%20z.%20o%20zru%u0161en%ED%20Fondu%20n%E1rodn%EDho%20majetku
55037,11,1320793200,85,60,1,2,148,A,Novela%20z.%20o%20zru%u0161en%ED%20Fondu%20n%E1rodn%EDho%20majetku
55038,12,1320793200,124,0,25,0,149,A,Novela%20z.%20o%20nemocensk%E9m%20poji%u0161t%u011Bn%ED
55039,12,1320793200,139,1,12,1,153,A,Novela%20z.%20o%20nemocensk%E9m%20poji%u0161t%u011Bn%ED
55040,12,1320793200,145,0,9,0,154,A,Novela%20z.%20o%20nemocensk%E9m%20poji%u0161t%u011Bn%ED
55041,12,1320793200,149,0,5,1,155,A,Novela%20z.%20o%20nemocensk%E9m%20poji%u0161t%u011Bn%ED
55042,12,1320793200,149,0,6,0,155,A,Novela%20z.%20o%20nemocensk%E9m%20poji%u0161t%u011Bn%ED
55043,12,1320793200,147,0,8,0,155,A,Novela%20z.%20o%20nemocensk%E9m%20poji%u0161t%u011Bn%ED
55044,12,1320793200,149,1,4,1,155,A,Novela%20z.%20o%20nemocensk%E9m%20poji%u0161t%u011Bn%ED
55045,13,1320793200,15,65,51,31,162,R,Vl.n.z.souvisej%EDc%ED%20se%20z%u0159%EDzen%EDm%20jednoho%20inkasn%EDho%20m%EDsta%20-%20EU
55046,13,1320793200,151,0,11,0,162,A,Vl.n.z.souvisej%EDc%ED%20se%20z%u0159%EDzen%EDm%20jednoho%20inkasn%EDho%20m%EDsta%20-%20EU
55047,13,1320793200,64,94,4,0,162,R,Vl.n.z.souvisej%EDc%ED%20se%20z%u0159%EDzen%EDm%20jednoho%20inkasn%EDho%20m%EDsta%20-%20EU
55048,13,1320793200,113,19,26,4,162,A,Vl.n.z.souvisej%EDc%ED%20se%20z%u0159%EDzen%EDm%20jednoho%20inkasn%EDho%20m%EDsta%20-%20EU
55049,13,1320793200,155,0,5,1,161,A,Vl.n.z.souvisej%EDc%ED%20se%20z%u0159%EDzen%EDm%20jednoho%20inkasn%EDho%20m%EDsta%20-%20EU
55050,13,1320793200,129,1,30,2,162,A,Vl.n.z.souvisej%EDc%ED%20se%20z%u0159%EDzen%EDm%20jednoho%20inkasn%EDho%20m%EDsta%20-%20EU
55051,13,1320793200,58,88,11,5,162,R,Vl.n.z.souvisej%EDc%ED%20se%20z%u0159%EDzen%EDm%20jednoho%20inkasn%EDho%20m%EDsta%20-%20EU
55052,13,1320793200,58,94,9,1,162,R,Vl.n.z.souvisej%EDc%ED%20se%20z%u0159%EDzen%EDm%20jednoho%20inkasn%EDho%20m%EDsta%20-%20EU
55053,13,1320793200,53,49,41,17,160,R,Vl.n.z.souvisej%EDc%ED%20se%20z%u0159%EDzen%EDm%20jednoho%20inkasn%EDho%20m%EDsta%20-%20EU
55054,13,1320793200,40,51,50,21,162,R,Vl.n.z.souvisej%EDc%ED%20se%20z%u0159%EDzen%EDm%20jednoho%20inkasn%EDho%20m%EDsta%20-%20EU
55055,13,1320793200,91,8,50,13,162,A,Vl.n.z.souvisej%EDc%ED%20se%20z%u0159%EDzen%EDm%20jednoho%20inkasn%EDho%20m%EDsta%20-%20EU
55056,13,1320793200,118,5,32,7,162,A,Vl.n.z.souvisej%EDc%ED%20se%20z%u0159%EDzen%EDm%20jednoho%20inkasn%EDho%20m%EDsta%20-%20EU
55057,13,1320793200,147,4,10,1,162,A,Vl.n.z.souvisej%EDc%ED%20se%20z%u0159%EDzen%EDm%20jednoho%20inkasn%EDho%20m%EDsta%20-%20EU
55058,13,1320793200,94,39,25,4,162,A,Vl.n.z.souvisej%EDc%ED%20se%20z%u0159%EDzen%EDm%20jednoho%20inkasn%EDho%20m%EDsta%20-%20EU
55059,13,1320793200,92,41,24,5,162,A,Vl.n.z.souvisej%EDc%ED%20se%20z%u0159%EDzen%EDm%20jednoho%20inkasn%EDho%20m%EDsta%20-%20EU
55060,13,1320793200,154,1,7,0,162,A,Vl.n.z.souvisej%EDc%ED%20se%20z%u0159%EDzen%EDm%20jednoho%20inkasn%EDho%20m%EDsta%20-%20EU
55061,13,1320793200,28,89,22,22,161,R,Vl.n.z.souvisej%EDc%ED%20se%20z%u0159%EDzen%EDm%20jednoho%20inkasn%EDho%20m%EDsta%20-%20EU
55062,13,1320793200,154,0,7,1,162,A,Vl.n.z.souvisej%EDc%ED%20se%20z%u0159%EDzen%EDm%20jednoho%20inkasn%EDho%20m%EDsta%20-%20EU
55063,13,1320793200,62,90,8,2,162,R,Vl.n.z.souvisej%EDc%ED%20se%20z%u0159%EDzen%EDm%20jednoho%20inkasn%EDho%20m%EDsta%20-%20EU
55064,13,1320793200,112,28,15,7,162,A,Vl.n.z.souvisej%EDc%ED%20se%20z%u0159%EDzen%EDm%20jednoho%20inkasn%EDho%20m%EDsta%20-%20EU
55065,13,1320793200,118,32,8,4,162,A,Vl.n.z.souvisej%EDc%ED%20se%20z%u0159%EDzen%EDm%20jednoho%20inkasn%EDho%20m%EDsta%20-%20EU
55066,13,1320793200,35,102,11,13,161,R,Vl.n.z.souvisej%EDc%ED%20se%20z%u0159%EDzen%EDm%20jednoho%20inkasn%EDho%20m%EDsta%20-%20EU
55067,13,1320793200,48,70,21,23,162,R,Vl.n.z.souvisej%EDc%ED%20se%20z%u0159%EDzen%EDm%20jednoho%20inkasn%EDho%20m%EDsta%20-%20EU
55068,13,1320793200,79,67,8,8,162,R,Vl.n.z.souvisej%EDc%ED%20se%20z%u0159%EDzen%EDm%20jednoho%20inkasn%EDho%20m%EDsta%20-%20EU
55069,13,1320793200,7,1,147,0,155,R,Vl.n.z.souvisej%EDc%ED%20se%20z%u0159%EDzen%EDm%20jednoho%20inkasn%EDho%20m%EDsta%20-%20EU
55070,13,1320793200,138,6,8,3,155,A,Vl.n.z.souvisej%EDc%ED%20se%20z%u0159%EDzen%EDm%20jednoho%20inkasn%EDho%20m%EDsta%20-%20EU
55071,13,1320793200,82,64,3,7,156,A,Vl.n.z.souvisej%EDc%ED%20se%20z%u0159%EDzen%EDm%20jednoho%20inkasn%EDho%20m%EDsta%20-%20EU
55072,13,1320793200,111,15,30,2,158,A,Vl.n.z.souvisej%EDc%ED%20se%20z%u0159%EDzen%EDm%20jednoho%20inkasn%EDho%20m%EDsta%20-%20EU
55073,13,1320793200,84,60,3,10,157,A,Vl.n.z.souvisej%EDc%ED%20se%20z%u0159%EDzen%EDm%20jednoho%20inkasn%EDho%20m%EDsta%20-%20EU
55074,13,1320793200,22,79,33,24,158,R,Vl.n.z.souvisej%EDc%ED%20se%20z%u0159%EDzen%EDm%20jednoho%20inkasn%EDho%20m%EDsta%20-%20EU
55075,13,1320793200,98,51,5,3,157,A,Vl.n.z.souvisej%EDc%ED%20se%20z%u0159%EDzen%EDm%20jednoho%20inkasn%EDho%20m%EDsta%20-%20EU
55076,13,1320793200,123,5,30,0,158,A,Vl.n.z.souvisej%EDc%ED%20se%20z%u0159%EDzen%EDm%20jednoho%20inkasn%EDho%20m%EDsta%20-%20EU
55077,13,1320793200,99,49,9,0,157,A,Vl.n.z.souvisej%EDc%ED%20se%20z%u0159%EDzen%EDm%20jednoho%20inkasn%EDho%20m%EDsta%20-%20EU
55078,13,1320793200,41,88,8,20,157,R,Vl.n.z.souvisej%EDc%ED%20se%20z%u0159%EDzen%EDm%20jednoho%20inkasn%EDho%20m%EDsta%20-%20EU
55079,13,1320793200,116,35,3,3,157,A,Vl.n.z.souvisej%EDc%ED%20se%20z%u0159%EDzen%EDm%20jednoho%20inkasn%EDho%20m%EDsta%20-%20EU
55080,13,1320793200,25,120,6,4,155,R,Vl.n.z.souvisej%EDc%ED%20se%20z%u0159%EDzen%EDm%20jednoho%20inkasn%EDho%20m%EDsta%20-%20EU
55081,13,1320793200,89,57,4,6,156,A,Vl.n.z.souvisej%EDc%ED%20se%20z%u0159%EDzen%EDm%20jednoho%20inkasn%EDho%20m%EDsta%20-%20EU
55082,13,1320793200,97,48,8,1,154,A,Vl.n.z.souvisej%EDc%ED%20se%20z%u0159%EDzen%EDm%20jednoho%20inkasn%EDho%20m%EDsta%20-%20EU
55083,13,1320793200,13,101,28,12,154,R,Vl.n.z.souvisej%EDc%ED%20se%20z%u0159%EDzen%EDm%20jednoho%20inkasn%EDho%20m%EDsta%20-%20EU
55084,13,1320793200,65,82,3,5,155,R,Vl.n.z.souvisej%EDc%ED%20se%20z%u0159%EDzen%EDm%20jednoho%20inkasn%EDho%20m%EDsta%20-%20EU
55085,13,1320793200,19,111,21,5,156,R,Vl.n.z.souvisej%EDc%ED%20se%20z%u0159%EDzen%EDm%20jednoho%20inkasn%EDho%20m%EDsta%20-%20EU
55086,13,1320793200,73,68,6,9,156,R,Vl.n.z.souvisej%EDc%ED%20se%20z%u0159%EDzen%EDm%20jednoho%20inkasn%EDho%20m%EDsta%20-%20EU
55087,13,1320793200,93,39,23,3,158,A,Vl.n.z.souvisej%EDc%ED%20se%20z%u0159%EDzen%EDm%20jednoho%20inkasn%EDho%20m%EDsta%20-%20EU
55088,13,1320793200,95,10,24,31,160,A,Vl.n.z.souvisej%EDc%ED%20se%20z%u0159%EDzen%EDm%20jednoho%20inkasn%EDho%20m%EDsta%20-%20EU
55089,13,1320793200,92,63,1,4,160,A,Vl.n.z.souvisej%EDc%ED%20se%20z%u0159%EDzen%EDm%20jednoho%20inkasn%EDho%20m%EDsta%20-%20EU
55090,0,1320793200,85,1,11,0,97,A,%20
55091,0,1320793200,42,57,8,11,118,R,Po%u0159ad%20sch%u016Fze
55092,0,1320793200,76,16,22,8,122,A,Po%u0159ad%20sch%u016Fze
55093,0,1320793200,69,19,24,11,123,A,Po%u0159ad%20sch%u016Fze
55094,0,1320793200,71,40,16,0,127,A,Po%u0159ad%20sch%u016Fze
55095,1,1320793200,102,4,18,9,133,A,Vl.n.z.%20o%20Finan%u010Dn%ED%20spr%E1v%u011B%20%u010Cesk%E9%20republiky
55096,1,1320793200,76,24,31,3,134,A,Vl.n.z.%20o%20Finan%u010Dn%ED%20spr%E1v%u011B%20%u010Cesk%E9%20republiky
55097,2,1320793200,107,4,20,4,135,A,Vl.n.z.%20v%20souvislosti%20s%20p%u0159ijet%EDm%20z%E1kona%20o%20Finan%u010Dn%ED%20spr%E1v%u011B%20%u010CR
55098,2,1320793200,77,19,33,6,135,A,Vl.n.z.%20v%20souvislosti%20s%20p%u0159ijet%EDm%20z%E1kona%20o%20Finan%u010Dn%ED%20spr%E1v%u011B%20%u010CR
55099,2,1320793200,99,24,11,0,134,A,Vl.n.z.%20v%20souvislosti%20s%20p%u0159ijet%EDm%20z%E1kona%20o%20Finan%u010Dn%ED%20spr%E1v%u011B%20%u010CR
55100,2,1320793200,35,81,15,5,136,R,Vl.n.z.%20v%20souvislosti%20s%20p%u0159ijet%EDm%20z%E1kona%20o%20Finan%u010Dn%ED%20spr%E1v%u011B%20%u010CR
55101,2,1320793200,79,18,31,8,136,A,Vl.n.z.%20v%20souvislosti%20s%20p%u0159ijet%EDm%20z%E1kona%20o%20Finan%u010Dn%ED%20spr%E1v%u011B%20%u010CR
55102,3,1320793200,99,7,18,7,131,A,Vl.n.z.%20o%20Celn%ED%20spr%E1v%u011B%20%u010Cesk%E9%20republiky%20-%20EU
55103,3,1320793200,118,3,11,0,132,A,Vl.n.z.%20o%20Celn%ED%20spr%E1v%u011B%20%u010Cesk%E9%20republiky%20-%20EU
55104,3,1320793200,72,21,30,9,132,A,Vl.n.z.%20o%20Celn%ED%20spr%E1v%u011B%20%u010Cesk%E9%20republiky%20-%20EU
55105,4,1320793200,95,14,21,1,131,A,Vl.n.z.%20v%20souvislosti%20s%20p%u0159ijet%EDm%20z%E1kona%20o%20Celn%ED%20spr%E1v%u011B%20%u010CR
55106,4,1320793200,73,19,34,5,131,A,Vl.n.z.%20v%20souvislosti%20s%20p%u0159ijet%EDm%20z%E1kona%20o%20Celn%ED%20spr%E1v%u011B%20%u010CR
55107,0,1323126000,114,0,54,0,168,A,%20
55108,0,1323126000,97,74,2,0,173,A,Po%u0159ad%20sch%u016Fze
55109,0,1323126000,127,20,11,21,179,A,Po%u0159ad%20sch%u016Fze
55110,0,1323126000,125,22,13,19,179,A,Po%u0159ad%20sch%u016Fze
55111,0,1323126000,104,19,33,25,181,A,Po%u0159ad%20sch%u016Fze
55112,0,1323126000,173,3,6,0,182,A,Po%u0159ad%20sch%u016Fze
55113,0,1323126000,79,85,9,9,182,R,Po%u0159ad%20sch%u016Fze
55114,0,1323126000,79,75,15,13,182,R,Po%u0159ad%20sch%u016Fze
55115,0,1323126000,76,83,10,14,183,R,Po%u0159ad%20sch%u016Fze
55116,0,1323126000,78,86,10,10,184,R,Po%u0159ad%20sch%u016Fze
55117,0,1323126000,79,90,8,8,185,R,Po%u0159ad%20sch%u016Fze
55118,0,1323126000,78,95,8,4,185,R,Po%u0159ad%20sch%u016Fze
55119,0,1323126000,78,97,7,3,185,R,Po%u0159ad%20sch%u016Fze
55120,0,1323126000,77,84,13,11,185,R,Po%u0159ad%20sch%u016Fze
55121,0,1323126000,173,6,5,0,184,A,Po%u0159ad%20sch%u016Fze
55122,0,1323126000,78,73,19,15,185,R,Po%u0159ad%20sch%u016Fze
55123,0,1323126000,139,13,11,21,184,A,Po%u0159ad%20sch%u016Fze
55124,0,1323126000,110,19,31,25,185,A,Po%u0159ad%20sch%u016Fze
55125,0,1323126000,78,99,6,2,185,R,Po%u0159ad%20sch%u016Fze
55126,0,1323126000,104,50,27,3,184,A,Po%u0159ad%20sch%u016Fze
55127,0,1323126000,103,53,25,3,184,A,Po%u0159ad%20sch%u016Fze
55128,0,1323126000,157,5,18,5,185,A,Po%u0159ad%20sch%u016Fze
55129,0,1323126000,100,51,30,4,185,A,Po%u0159ad%20sch%u016Fze
55130,0,1323126000,145,10,25,5,185,A,Po%u0159ad%20sch%u016Fze
55131,0,1323126000,154,11,13,7,185,A,Po%u0159ad%20sch%u016Fze
55132,0,1323126000,106,71,4,4,185,A,Po%u0159ad%20sch%u016Fze
55133,0,1323126000,103,50,28,4,185,A,Po%u0159ad%20sch%u016Fze
55134,0,1323126000,136,2,15,2,155,A,%20
55135,109,1323126000,70,91,2,3,166,R,N%E1vrh%20na%20zm%u011Bnu%20usnesen%ED%20PS%20%u010D.%2011
55136,109,1323126000,87,68,8,3,166,A,N%E1vrh%20na%20zm%u011Bnu%20usnesen%ED%20PS%20%u010D.%2011
55137,110,1323126000,147,4,3,4,158,A,N%E1vrh%20na%20zm%u011Bnu%20usnesen%ED%20PS%20%u010D.%2012
55138,110,1323126000,88,39,24,9,160,A,N%E1vrh%20na%20zm%u011Bnu%20usnesen%ED%20PS%20%u010D.%2012
55139,110,1323126000,158,0,4,1,163,A,N%E1vrh%20na%20zm%u011Bnu%20usnesen%ED%20PS%20%u010D.%2012
55140,110,1323126000,89,49,21,4,163,A,N%E1vrh%20na%20zm%u011Bnu%20usnesen%ED%20PS%20%u010D.%2012
55141,2,1323126000,120,30,10,6,166,A,N.z.o%20trestn%ED%20odpov%u011Bdnosti%20pr%E1v.%20osob%20a%20%u0159%EDzen%ED%20proti%20nim%20-%20EU
55142,3,1323126000,123,27,12,6,168,A,N.z.%20o%20zm%u011Bn%u011B%20z%E1kon%u016F%20v%20souvisl.s%20p%u0159ij.z%E1k.o%20tr.odpov%u011Bdnosti
55143,0,1323126000,145,2,22,2,171,A,%20
55144,4,1323126000,149,0,25,0,174,A,Novela%20z.%20o%20rozpo%u010Dtov%FDch%20pravidlech
55145,5,1323126000,61,81,3,5,150,R,Novela%20z.%20o%20znalc%EDch%20a%20tlumo%u010Dn%EDc%EDch
55146,5,1323126000,158,1,5,0,164,A,Novela%20z.%20o%20znalc%EDch%20a%20tlumo%u010Dn%EDc%EDch
55147,6,1323126000,159,0,9,0,168,A,Novela%20z.%20o%20obchodov%E1n%ED%20s%20ohro%u017Een%FDmi%20druhy%20-%20EU
55148,7,1323126000,60,85,22,2,169,R,Novela%20z.%20o%20trestn%EDm%20%u0159%EDzen%ED%20soudn%EDm%20%28trestn%ED%20%u0159%E1d%29%20-%20EU
55149,7,1323126000,127,10,16,17,170,A,Novela%20z.%20o%20trestn%EDm%20%u0159%EDzen%ED%20soudn%EDm%20%28trestn%ED%20%u0159%E1d%29%20-%20EU
55150,8,1323126000,61,96,15,1,173,R,Novela%20z.%20o%20elektronick%FDch%20komunikac%EDch%20-%20EU
55151,8,1323126000,156,0,15,4,175,A,Novela%20z.%20o%20elektronick%FDch%20komunikac%EDch%20-%20EU
55152,9,1323126000,62,98,12,2,174,R,N.z.%20o%20zru%u0161en%ED%20z%E1kona%20o%20ve%u0159ej.%20nezis.%20%FAstav.%20zdrav.%20za%u0159%EDz.
55153,9,1323126000,101,60,12,0,173,A,N.z.%20o%20zru%u0161en%ED%20z%E1kona%20o%20ve%u0159ej.%20nezis.%20%FAstav.%20zdrav.%20za%u0159%EDz.
55154,9,1323126000,157,2,13,1,173,A,N.z.%20o%20zru%u0161en%ED%20z%E1kona%20o%20ve%u0159ej.%20nezis.%20%FAstav.%20zdrav.%20za%u0159%EDz.
55155,9,1323126000,102,61,10,0,173,A,N.z.%20o%20zru%u0161en%ED%20z%E1kona%20o%20ve%u0159ej.%20nezis.%20%FAstav.%20zdrav.%20za%u0159%EDz.
55156,10,1323126000,90,57,16,5,168,R,Novela%20z.%20o%20pomoci%20v%20hmotn%E9%20nouzi
55157,11,1323126000,104,40,24,0,168,A,Novela%20z.%20o%20slu%u017Eb%u011B%20st%E1tn%EDch%20zam%u011Bstnanc%u016F
55158,0,1323212400,101,0,18,0,119,A,Po%u0159ad%20sch%u016Fze
55159,13,1323212400,108,0,1,0,109,A,Novela%20z.%20-%20%DAstava%20%u010Cesk%E9%20republiky
55160,24,1323212400,128,1,13,0,142,A,Novela%20z.%20o%20m%EDstn%EDch%20poplatc%EDch
55161,28,1323212400,112,1,34,1,148,A,Novela%20z.%20o%20pozemn%EDch%20komunikac%EDch
55162,0,1323298800,68,2,5,3,78,A,Po%u0159ad%20sch%u016Fze
55163,0,1323298800,59,4,15,4,82,A,Po%u0159ad%20sch%u016Fze
55164,0,1323298800,74,2,9,0,85,A,Po%u0159ad%20sch%u016Fze
55165,141,1323298800,42,45,23,0,110,R,P%EDsemn%E1%20interpelace%20J.%20Tejce%20na%20A.%20Vondru%20ve%20v%u011Bci%20v%FD%u0161e%20plat%u016F%2C%20odm%u011Bn%20a
55166,141,1323298800,79,1,30,1,111,A,P%EDsemn%E1%20interpelace%20J.%20Tejce%20na%20K.%20Schwarzenberga%20ve%20v%u011Bci%20v%FD%u0161e%20plat%u016F%2C
55167,141,1323298800,46,39,3,1,89,A,P%EDsemn%E1%20interpelace%20K.%20Kone%u010Dn%E9%20na%20M.%20Kubu%20ve%20v%u011Bci%20d%u016Fln%EDho%20d%EDla%20%u017Deb
55168,141,1323298800,42,59,13,1,115,R,P%EDsemn%E1%20interpelace%20D.%20Ratha%20na%20P.%20Ne%u010Dase%20ve%20v%u011Bci%20informace%20o%20v%FD%u0161i%20pla
55169,56,1323298800,71,59,2,0,132,A,Sm%u011Brnice%20Rady%20o%20spole%u010Dn%E9m%20syst%E9mu%20dan%u011B%20z%20fin.%20transakc%ED
55170,117,1323298800,84,7,14,13,118,A,N%E1vrh%20na%20zm%u011Bnu%20jednac%EDho%20po%u0159%E1dku%20v%20jednac%EDm%20s%E1le%20PS
55171,134,1323298800,114,0,7,0,121,A,N%E1vrh%20II.%20zm%u011Bny%20rozpo%u010Dtu%20SFRB%20na%20rok%202011
55172,57,1323298800,113,1,10,0,124,A,Zm%u011Bny%20%DAml.%20Mezin%E1rodn%ED%20dru%u017Eicov%E9%20org.%20pro%20pohybliv%E9%20slu%u017Eby
55173,58,1323298800,110,1,13,0,124,A,P%u0159%EDstup%20%u010CR%20k%20revid.%20Prot.%20o%20Mez.dru%u017E.org.%20pro%20pohyb.%20slu%u017Eby
55174,59,1323298800,109,1,14,0,124,A,Doh.%20mezi%20%u010CR%20a%20vl.%20Argentinsk%E9%20rep.%20o%20leteck%FDch%20slu%u017Eb%E1ch
55175,60,1323298800,107,1,13,1,122,A,Mezin%E1rodn%ED%20%FAmluva%20proti%20dopingu%20ve%20sportu
55176,61,1323298800,101,1,19,0,121,A,Doh.%20o%20z%u0159%EDzen%ED%20St%u0159edoevr.%20funk%u010Dn%EDho%20bloku%20vzdu%u0161n%E9ho%20prostoru
55177,62,1323298800,100,1,19,0,120,A,Doh.o%20z%u0159%EDzen%ED%20a%20provozov%E1n%ED%20letov%FDch%20slu%u017Eeb%20org.%20EUROCONTROL
55178,63,1323298800,94,1,3,0,98,A,Doh.mezi%20%u010CR%20a%20%C1zerb%E1jd%u017E%E1nskou%20rep.%20o%20podpo%u0159e%20a%20ochr.investic
55179,64,1323298800,100,0,4,0,104,A,Sml.%20mezi%20%u010CR%20a%20Kr%E1l.%20Bahrajn%20o%20zamezen%ED%20dvoj.%20zdan%u011Bn%ED
55180,65,1323298800,94,1,10,0,105,A,Prot.%20o%20trvale%20udr%u017Eiteln%E9m%20obhospoda%u0159ov%E1n%ED%20les%u016F
55181,67,1323298800,95,0,12,0,107,A,Sml.%20mezi%20%u010CR%20a%20vl.%20Hongkongu%20o%20zamezen%ED%20dvoj%EDmu%20zdan%u011Bn%ED
55182,68,1323298800,100,0,8,0,108,A,Prot.%20k%20R%E1mcov%E9%20%FAml.%20o%20ochran%u011B%20a%20udr%u017Eiteln%E9m%20rozvoji%20Karpat
55183,69,1323298800,102,2,5,0,109,A,Sml.mezi%20%u010CR%20a%20Kyperskou%20rep.%20o%20vz%E1jemn%E9%20ochr.%20utaj.informac%ED
55184,70,1323298800,102,1,6,0,109,A,Doh.%20mezi%20st%E1ty%20EU%20o%20ochran%u011B%20utajovan%FDch%20informac%ED
55185,71,1323298800,101,1,8,0,110,A,Nagojsko-kualalumpursk%FD%20prot.%20o%20odpov%u011Bdnosti%20a%20n%E1hr.%u0161kod
55186,73,1323298800,100,2,8,0,110,A,Sml.%20mezi%20%u010CR%20a%20vl.%20%C1zerb%E1jd.rep.%20o%20ochr.%20utaj.%20informac%ED
55187,74,1323298800,107,1,6,0,114,A,Doh.%20o%20Mezin%E1rodn%ED%20bance%20pro%20obnovu%20a%20rozvoj
55188,75,1323298800,107,1,6,0,114,A,Doh.%20mezi%20%u010CR%20a%20Organiz.%20pro%20z%E1kaz%20chem.%20zbran%ED%20o%20inspekc%EDch
55189,76,1323298800,105,0,10,0,115,A,Doh.%20mezi%20%u010CR%20a%20vl%E1dou%20Brit.Panen.ostrov%u016F%20o%20v%FDm%u011Bn%u011B%20informac%ED
55190,77,1323298800,110,0,8,0,118,A,Doporu%u010Den%ED%20MOP%20%u010D.%20200%20o%20HIV%20a%20AIDS%20a%20sv%u011Bt%u011B%20pr%E1ce
55191,78,1323298800,112,1,5,0,118,A,Sml.%20mezi%20%u010CR%20a%20Polskou%20rep.%20o%20zamezen%ED%20dvoj%EDmu%20zdan%u011Bn%ED
55192,79,1323298800,109,1,9,0,119,A,Doh.mezi%20%u010CR%20a%20Ostrovem%20Man%20o%20v%FDm%u011Bn%u011B%20inf.v%20da%u0148.z%E1le%u017Eitostech
55193,80,1323298800,93,1,11,0,105,A,Doh.mezi%20%u010CR%20a%20vl.%20Guernsey%20o%20v%FDm.inf.v%20da%u0148.z%E1le%u017Eitostech
55194,80,1323298800,112,1,2,0,115,A,Doh.mezi%20%u010CR%20a%20vl.%20Guernsey%20o%20v%FDm.inf.v%20da%u0148.z%E1le%u017Eitostech
55195,81,1323298800,111,1,3,0,115,A,Prot.%20mezi%20%u010CR%20a%20Chorvat.%20rep.%20o%20zamezen%ED%20dvoj.%20zdan%u011Bn%ED
55196,0,1323385200,105,2,11,1,119,A,Po%u0159ad%20sch%u016Fze
55197,0,1323385200,107,3,13,0,123,A,Po%u0159ad%20sch%u016Fze
55198,0,1323385200,116,3,4,0,123,A,Po%u0159ad%20sch%u016Fze
55199,0,1323385200,121,3,2,0,126,A,Po%u0159ad%20sch%u016Fze
55200,0,1323385200,67,40,9,9,125,A,Po%u0159ad%20sch%u016Fze
55201,0,1323385200,102,11,12,3,128,A,Po%u0159ad%20sch%u016Fze
55202,66,1323385200,118,3,32,3,156,A,R%E1mcov%E1%20%FAmluva%20o%20kontrole%20tab%E1ku
55203,32,1323385200,123,1,37,0,161,A,Novela%20z.%20o%20po%u0161tovn%EDch%20slu%u017Eb%E1ch%20-%20EU
55204,32,1323385200,104,17,35,5,161,A,Novela%20z.%20o%20po%u0161tovn%EDch%20slu%u017Eb%E1ch%20-%20EU
55205,35,1323385200,127,1,32,0,160,A,Novela%20z.%20-%20ob%u010Dansk%FD%20z%E1kon%EDk
55206,36,1323385200,62,76,1,3,142,R,Novela%20z.%20o%20p%u0159izn%E1n%ED%20k%20registrovan%E9mu%20majetku
55207,36,1323385200,74,62,9,0,145,A,Novela%20z.%20o%20p%u0159izn%E1n%ED%20k%20registrovan%E9mu%20majetku
55208,36,1323385200,132,2,11,0,145,A,Novela%20z.%20o%20p%u0159izn%E1n%ED%20k%20registrovan%E9mu%20majetku
55209,36,1323385200,76,66,2,1,145,A,Novela%20z.%20o%20p%u0159izn%E1n%ED%20k%20registrovan%E9mu%20majetku
55210,37,1323385200,111,0,31,0,142,A,Novela%20z.%20o%20p%u0159echodu%20v%u011Bc%ED%20z%20majetku%20%u010CR%20do%20vlastnictv%ED%20obc%ED
55211,37,1323385200,115,0,28,0,143,A,Novela%20z.%20o%20p%u0159echodu%20v%u011Bc%ED%20z%20majetku%20%u010CR%20do%20vlastnictv%ED%20obc%ED
55212,38,1323385200,49,77,18,0,144,R,Novela%20z.%20-%20trestn%ED%20%u0159%E1d
55213,38,1323385200,125,0,19,0,144,A,Novela%20z.%20-%20trestn%ED%20%u0159%E1d
55214,0,1323730800,135,8,24,4,171,A,Po%u0159ad%20sch%u016Fze
55215,0,1323730800,164,0,9,0,173,A,Po%u0159ad%20sch%u016Fze
55216,0,1323730800,159,2,12,0,173,A,Po%u0159ad%20sch%u016Fze
55217,0,1323730800,156,2,15,1,174,A,Po%u0159ad%20sch%u016Fze
55218,0,1323730800,73,74,14,13,174,R,Po%u0159ad%20sch%u016Fze
55219,0,1323730800,111,24,25,14,174,A,Po%u0159ad%20sch%u016Fze
55220,0,1323730800,84,24,42,24,174,R,Po%u0159ad%20sch%u016Fze
55221,0,1323730800,73,28,55,18,174,R,Po%u0159ad%20sch%u016Fze
55222,0,1323730800,134,1,38,0,173,A,%20
55223,127,1323730800,112,14,31,17,174,A,Zpr%E1va%20o%20finan%u010Dn%ED%20stabilit%u011B%202010/2011
55224,128,1323730800,126,1,50,0,177,A,Zpr%E1va%20o%20v%FDkonu%20dohledu%20nad%20finan%u010Dn%EDm%20trhem%20v%20roce%202010
55225,129,1323730800,133,1,43,1,178,A,Zpr%E1va%20o%20inflaci%20-%20%u010Dervenec%202011
55226,135,1323730800,108,2,66,1,177,A,Zpr%E1va%20vl%E1dy%20o%20vyu%u017Eit%ED%20doporu%u010Den%ED%20ve%u0159ejn%E9ho%20ochr%E1nce%20pr%E1v
55227,105,1323730800,143,0,31,0,174,A,N%E1vrh%20na%20zm%u011Bny%20ve%20slo%u017Een%ED%20org%E1n%u016F%20Poslaneck%E9%20sn%u011Bmovny
55228,105,1323730800,144,0,30,0,174,A,N%E1vrh%20na%20zm%u011Bny%20ve%20slo%u017Een%ED%20org%E1n%u016F%20Poslaneck%E9%20sn%u011Bmovny
55229,113,1323730800,148,1,26,0,175,A,N%E1vrh%20na%20ustaven%ED%20SK%20GIBS
55230,114,1323730800,149,0,24,2,175,A,N%E1vrh%20na%20ustaven%ED%20nov%u011B%20z%u0159%EDzen%FDch%20v%FDbor%u016F
55231,114,1323730800,145,6,24,2,177,A,N%E1vrh%20na%20ustaven%ED%20nov%u011B%20z%u0159%EDzen%FDch%20v%FDbor%u016F
55232,114,1323730800,140,4,28,5,177,A,N%E1vrh%20na%20ustaven%ED%20nov%u011B%20z%u0159%EDzen%FDch%20v%FDbor%u016F
55233,31,1323730800,121,0,55,0,176,A,Novela%20z.%20o%20dluhopisech%20-%20EU
55234,41,1323730800,127,2,43,2,174,A,Novela%20z.%20o%20rozpo%u010Dtov%FDch%20pravidlech
55235,43,1323730800,8,1,162,0,171,R,Novela%20z.%20o%20bank%E1ch
55236,43,1323730800,129,1,43,0,173,A,Novela%20z.%20o%20bank%E1ch
55237,43,1323730800,56,64,47,6,173,R,Novela%20z.%20o%20bank%E1ch
55238,29,1323730800,112,1,59,0,172,A,Novela%20z.%20o%20silni%u010Dn%ED%20doprav%u011B%20-%20EU
55239,29,1323730800,69,16,77,11,173,R,Novela%20z.%20o%20silni%u010Dn%ED%20doprav%u011B%20-%20EU
55240,29,1323730800,101,8,9,3,121,A,Novela%20z.%20o%20silni%u010Dn%ED%20doprav%u011B%20-%20EU
55241,29,1323730800,76,22,22,9,129,A,Novela%20z.%20o%20silni%u010Dn%ED%20doprav%u011B%20-%20EU
55242,30,1323730800,126,1,19,0,146,A,Novela%20z.%20o%20pozemn%EDch%20komunikac%EDch%20-%20EU
55243,30,1323730800,105,20,22,2,149,A,Novela%20z.%20o%20pozemn%EDch%20komunikac%EDch%20-%20EU
55244,30,1323730800,79,38,25,7,149,A,Novela%20z.%20o%20pozemn%EDch%20komunikac%EDch%20-%20EU
55245,45,1323730800,23,99,2,6,130,R,Novela%20z.%20o%20da%u0148ov%E9m%20poradenstv%ED
55246,45,1323730800,126,2,4,0,132,A,Novela%20z.%20o%20da%u0148ov%E9m%20poradenstv%ED
55247,46,1323730800,121,2,17,0,140,A,Novela%20z.%2C%20kter%FDm%20se%20zm%EDr%u0148uj%ED%20majetkov%E9%20k%u0159ivdy%20ob%u010Dan%u016Fm%20%u010CR
55248,46,1323730800,106,10,24,0,140,A,Novela%20z.%2C%20kter%FDm%20se%20zm%EDr%u0148uj%ED%20majetkov%E9%20k%u0159ivdy%20ob%u010Dan%u016Fm%20%u010CR
55249,49,1323730800,64,59,3,1,127,A,Novela%20z.%20o%20soudech%20a%20soudc%EDch
55250,51,1323730800,91,10,33,7,141,A,N.z.%20o%20soci%E1ln%EDm%20bydlen%ED
55251,0,1323730800,110,4,28,0,142,A,%20
55252,0,1323730800,60,8,21,12,101,A,%20
55253,144,1323730800,82,6,9,13,110,A,Informace%20p%u0159edsedy%20vl%E1dy%20o%20jedn%E1n%ED%20Evropsk%E9%20rady
55254,144,1323730800,38,50,10,12,110,R,Informace%20p%u0159edsedy%20vl%E1dy%20o%20jedn%E1n%ED%20Evropsk%E9%20rady
55255,89,1323817200,186,0,4,0,190,A,Novela%20z.%20-%20%DAstava%20%u010Cesk%E9%20republiky
55256,89,1323817200,187,0,2,1,190,A,Novela%20z.%20-%20%DAstava%20%u010Cesk%E9%20republiky
55257,89,1323817200,186,1,2,1,190,A,Novela%20z.%20-%20%DAstava%20%u010Cesk%E9%20republiky
55258,89,1323817200,56,106,21,7,190,R,Novela%20z.%20-%20%DAstava%20%u010Cesk%E9%20republiky
55259,89,1323817200,58,106,24,2,190,R,Novela%20z.%20-%20%DAstava%20%u010Cesk%E9%20republiky
55260,89,1323817200,26,153,3,8,190,R,Novela%20z.%20-%20%DAstava%20%u010Cesk%E9%20republiky
55261,89,1323817200,179,4,3,5,191,A,Novela%20z.%20-%20%DAstava%20%u010Cesk%E9%20republiky
55262,89,1323817200,162,2,25,3,192,A,Novela%20z.%20-%20%DAstava%20%u010Cesk%E9%20republiky
55263,89,1323817200,26,152,4,10,192,R,Novela%20z.%20-%20%DAstava%20%u010Cesk%E9%20republiky
55264,89,1323817200,32,119,10,31,192,R,Novela%20z.%20-%20%DAstava%20%u010Cesk%E9%20republiky
55265,89,1323817200,52,121,6,13,192,R,Novela%20z.%20-%20%DAstava%20%u010Cesk%E9%20republiky
55266,89,1323817200,159,3,24,6,192,A,Novela%20z.%20-%20%DAstava%20%u010Cesk%E9%20republiky
55267,82,1323817200,135,0,54,0,189,A,Vl.n.z.%20o%20st%E1tn%EDm%20rozpo%u010Dtu%20%u010CR%20na%20rok%202012
55268,82,1323817200,122,33,7,24,186,A,Vl.n.z.%20o%20st%E1tn%EDm%20rozpo%u010Dtu%20%u010CR%20na%20rok%202012
55269,82,1323817200,156,15,8,8,187,A,Vl.n.z.%20o%20st%E1tn%EDm%20rozpo%u010Dtu%20%u010CR%20na%20rok%202012
55270,82,1323817200,80,102,3,2,187,R,Vl.n.z.%20o%20st%E1tn%EDm%20rozpo%u010Dtu%20%u010CR%20na%20rok%202012
55271,82,1323817200,181,2,3,1,187,A,Vl.n.z.%20o%20st%E1tn%EDm%20rozpo%u010Dtu%20%u010CR%20na%20rok%202012
55272,82,1323817200,180,3,1,4,188,A,Vl.n.z.%20o%20st%E1tn%EDm%20rozpo%u010Dtu%20%u010CR%20na%20rok%202012
55273,82,1323817200,183,1,3,1,188,A,Vl.n.z.%20o%20st%E1tn%EDm%20rozpo%u010Dtu%20%u010CR%20na%20rok%202012
55274,82,1323817200,37,114,11,27,189,R,Vl.n.z.%20o%20st%E1tn%EDm%20rozpo%u010Dtu%20%u010CR%20na%20rok%202012
55275,82,1323817200,84,98,3,3,188,R,Vl.n.z.%20o%20st%E1tn%EDm%20rozpo%u010Dtu%20%u010CR%20na%20rok%202012
55276,82,1323817200,78,103,5,2,188,R,Vl.n.z.%20o%20st%E1tn%EDm%20rozpo%u010Dtu%20%u010CR%20na%20rok%202012
55277,82,1323817200,92,70,8,18,188,R,Vl.n.z.%20o%20st%E1tn%EDm%20rozpo%u010Dtu%20%u010CR%20na%20rok%202012
55278,82,1323817200,80,80,11,17,188,R,Vl.n.z.%20o%20st%E1tn%EDm%20rozpo%u010Dtu%20%u010CR%20na%20rok%202012
55279,82,1323817200,45,108,10,26,189,R,Vl.n.z.%20o%20st%E1tn%EDm%20rozpo%u010Dtu%20%u010CR%20na%20rok%202012
55280,82,1323817200,76,109,2,2,189,R,Vl.n.z.%20o%20st%E1tn%EDm%20rozpo%u010Dtu%20%u010CR%20na%20rok%202012
55281,82,1323817200,77,107,3,2,189,R,Vl.n.z.%20o%20st%E1tn%EDm%20rozpo%u010Dtu%20%u010CR%20na%20rok%202012
55282,82,1323817200,78,107,4,0,189,R,Vl.n.z.%20o%20st%E1tn%EDm%20rozpo%u010Dtu%20%u010CR%20na%20rok%202012
55283,82,1323817200,81,100,5,2,188,R,Vl.n.z.%20o%20st%E1tn%EDm%20rozpo%u010Dtu%20%u010CR%20na%20rok%202012
55284,82,1323817200,81,98,7,2,188,R,Vl.n.z.%20o%20st%E1tn%EDm%20rozpo%u010Dtu%20%u010CR%20na%20rok%202012
55285,82,1323817200,77,86,10,14,187,R,Vl.n.z.%20o%20st%E1tn%EDm%20rozpo%u010Dtu%20%u010CR%20na%20rok%202012
55286,82,1323817200,96,69,13,9,187,A,Vl.n.z.%20o%20st%E1tn%EDm%20rozpo%u010Dtu%20%u010CR%20na%20rok%202012
55287,82,1323817200,153,9,18,7,187,A,Vl.n.z.%20o%20st%E1tn%EDm%20rozpo%u010Dtu%20%u010CR%20na%20rok%202012
55288,82,1323817200,90,73,11,12,186,R,Vl.n.z.%20o%20st%E1tn%EDm%20rozpo%u010Dtu%20%u010CR%20na%20rok%202012
55289,82,1323817200,80,101,5,2,188,R,Vl.n.z.%20o%20st%E1tn%EDm%20rozpo%u010Dtu%20%u010CR%20na%20rok%202012
55290,82,1323817200,178,4,4,2,188,A,Vl.n.z.%20o%20st%E1tn%EDm%20rozpo%u010Dtu%20%u010CR%20na%20rok%202012
55291,82,1323817200,104,79,3,2,188,A,Vl.n.z.%20o%20st%E1tn%EDm%20rozpo%u010Dtu%20%u010CR%20na%20rok%202012
55292,82,1323817200,80,102,2,2,186,R,Vl.n.z.%20o%20st%E1tn%EDm%20rozpo%u010Dtu%20%u010CR%20na%20rok%202012
55293,83,1323817200,0,1,172,0,173,R,St%u0159edn%u011Bdob%E9%20v%FDdajov%E9%20r%E1mce%20na%20l%E9ta%202013%20a%202014
55294,83,1323817200,84,67,1,0,152,A,St%u0159edn%u011Bdob%E9%20v%FDdajov%E9%20r%E1mce%20na%20l%E9ta%202013%20a%202014
55295,84,1323817200,123,12,10,1,146,A,Rozpo%u010Det%20SFDI%20na%20rok%202012
55296,85,1323817200,87,32,27,2,148,A,N%E1vrh%20rozpo%u010Dtu%20St%E1tn%EDho%20fondu%20rozvoje%20bydlen%ED%20na%20rok%202012
55297,86,1323817200,107,5,21,11,144,A,Dota%u010Dn%ED%20programy%20zem%u011Bd%u011Blstv%ED%20pro%20rok%202012
55298,87,1323817200,106,14,22,4,146,A,N%E1vrh%20rozpo%u010Dtu%20SZIF%20na%20rok%202012
55299,33,1323817200,125,0,17,0,142,A,Novela%20z.%20o%20posuzov%E1n%ED%20vliv%u016F%20na%20%u017Eivotn%ED%20prost%u0159ed%ED%20-%20EU
55300,33,1323817200,107,0,34,1,142,A,Novela%20z.%20o%20posuzov%E1n%ED%20vliv%u016F%20na%20%u017Eivotn%ED%20prost%u0159ed%ED%20-%20EU
55301,33,1323817200,100,1,39,2,142,A,Novela%20z.%20o%20posuzov%E1n%ED%20vliv%u016F%20na%20%u017Eivotn%ED%20prost%u0159ed%ED%20-%20EU
55302,0,1323903600,50,3,18,1,72,A,Po%u0159ad%20sch%u016Fze
55303,0,1323903600,33,34,11,7,85,R,Po%u0159ad%20sch%u016Fze
55304,0,1323903600,32,24,14,17,87,R,Po%u0159ad%20sch%u016Fze
55305,141,1323903600,23,38,32,0,93,R,P%EDsemn%E1%20interpelace%20M.%20V%E1ni%20na%20P.%20Ne%u010Dase%20ve%20v%u011Bci%20vl%E1dn%EDch%20%u0161krt%u016F%20ve%20v%FDd
55306,141,1323903600,31,40,0,0,71,R,P%EDsemn%E1%20interpelace%20M.%20V%E1ni%20na%20P.%20Ne%u010Dase%20ve%20v%u011Bci%20Komu%20slou%u017E%ED%20da%u0148ov%E1%20re
55307,72,1323903600,49,64,4,3,120,R,Sml.%20mezi%20%u010CR%20a%20Rep.%20Kosovo%20o%20zp%u011Btn%E9m%20p%u0159eb%EDr%E1n%ED%20osob
55308,72,1323903600,65,46,5,5,121,A,Sml.%20mezi%20%u010CR%20a%20Rep.%20Kosovo%20o%20zp%u011Btn%E9m%20p%u0159eb%EDr%E1n%ED%20osob
55309,122,1323903600,94,2,27,4,127,A,Zpr%E1va%20o%20situaci%20v%20oblasti%20ve%u0159ejn%E9ho%20po%u0159%E1dku%20v%20roce%202010
55310,123,1323903600,94,0,30,1,125,A,Zpr%E1va%20o%20problematice%20extremismu%20na%20%FAzem%ED%20%u010CR%20v%20roce%202010
55311,124,1323903600,7,0,117,0,124,R,Zpr.o%20situaci%20v%20oblasti%20migrace%20na%20%FAzem%ED%20%u010CR%20v%20roce%202010
55312,124,1323903600,84,0,40,0,124,A,Zpr.o%20situaci%20v%20oblasti%20migrace%20na%20%FAzem%ED%20%u010CR%20v%20roce%202010
55313,118,1323903600,75,1,47,3,126,A,V%FDro%u010Dn%ED%20zpr%E1va%20o%20%u010Dinnosti%20%u010Cesk%E9%20televize%20v%20roce%202010
55314,119,1323903600,75,4,47,1,127,A,V%FDro%u010Dn%ED%20zpr%E1va%20o%20hospoda%u0159en%ED%20%u010Cesk%E9%20televize%20v%20roce%202010
55315,0,1323903600,41,6,47,1,95,R,%20
55316,0,1323903600,74,12,18,6,110,A,%20
55317,115,1323903600,76,11,18,5,110,A,N%E1vrh%20na%20potvrzen%ED%20p%u0159edsed%u016F%20v%FDbor%u016F
55318,115,1323903600,56,48,5,2,111,A,N%E1vrh%20na%20potvrzen%ED%20p%u0159edsed%u016F%20v%FDbor%u016F
55319,115,1323903600,101,9,5,0,115,A,N%E1vrh%20na%20potvrzen%ED%20p%u0159edsed%u016F%20v%FDbor%u016F
55320,115,1323903600,104,2,8,4,118,A,N%E1vrh%20na%20potvrzen%ED%20p%u0159edsed%u016F%20v%FDbor%u016F
55321,105,1323903600,115,1,5,0,121,A,N%E1vrh%20na%20zm%u011Bny%20ve%20slo%u017Een%ED%20org%E1n%u016F%20Poslaneck%E9%20sn%u011Bmovny
55322,105,1323903600,118,0,3,0,121,A,N%E1vrh%20na%20zm%u011Bny%20ve%20slo%u017Een%ED%20org%E1n%u016F%20Poslaneck%E9%20sn%u011Bmovny
55323,107,1323903600,105,1,13,2,121,A,Volba%20%u010Dlen%u016F%20Etick%E9%20komise%20%u010CR%20pro%20ocen%u011Bn%ED%20%FA%u010Dastn%EDk%u016F%20odboje
55324,108,1323903600,111,0,10,0,121,A,N%E1vrh%20na%20volbu%20%u010Dlen%u016F%20DR%20PF%20%u010CR
55325,109,1323903600,116,0,5,1,122,A,N%E1vrh%20na%20volbu%20%u010Dlen%u016F%20R%20SF%20pro%20podporu%20kinematografie
55326,110,1323903600,118,0,6,0,124,A,N%E1vrh%20na%20volbu%20%u010Dlen%u016F%20R%20SFK%20%u010CR
55327,121,1323903600,34,29,45,4,112,R,V%FDro%u010Dn%ED%20zpr%E1va%20o%20%u010Dinnosti%20a%20hospoda%u0159en%ED%20%u010CTK%20v%20roce%202010
55328,125,1323903600,62,4,3,4,73,A,Informace%20o%20podpo%u0159en%E9m%20financov%E1n%ED%20za%20rok%202010
55329,126,1323903600,73,0,3,0,76,A,Inf.%20o%20poji%u0161%u0165ov%E1n%ED%20v%FDvozu%20se%20st%E1tn%ED%20podporou%20v%20roce%202010
55330,130,1323903600,69,0,8,0,77,A,Inf.o%20vojensk%FDch%20cvi%u010Den%EDch%20A%u010CR%20za%20obdob%ED%20leden%20-%20%u010Derven%202011
55331,131,1323903600,65,12,2,0,79,A,Inf.%20o%20p%u0159eletech%20a%20pr%u016Fjezdech%20ozbroj.%20sil%20v%201.%20pol.%202011
55332,132,1323903600,72,4,5,0,81,A,2.%20dopln%u011Bk%20pl%E1nu%20voj.cvi%u010Den%ED%20A%u010CR%20se%20zahr.partnery%20v%20r.%202010
55333,133,1323903600,81,0,2,0,83,A,Zpr%E1va%20o%20petic%EDch%20za%20obdob%ED%20od%201.%201.%202011%20do%2030.%206.%202011
55334,136,1323903600,42,27,9,6,84,R,V%FDro%u010Dn%ED%20zpr%E1vy%20a%20z%E1v%u011Brky%20zdravotn%EDch%20poji%u0161%u0165oven%20za%20rok%202010
55335,137,1323903600,50,18,20,6,94,A,Zpr%E1va%20o%20pln%u011Bn%ED%20st%E1tn%EDho%20rozpo%u010Dtu%20%u010CR%20za%201.%20pololet%ED%202011
55336,137,1323903600,53,30,1,2,86,A,Zpr%E1va%20o%20pln%u011Bn%ED%20st%E1tn%EDho%20rozpo%u010Dtu%20%u010CR%20za%201.%20pololet%ED%202011
55337,138,1323903600,60,9,11,10,90,A,Zpr.o%20%u010Dinnosti%20kontrol.%20Grantov%E9%20agentury%20%u010CR%20r.%202010%20-%2011
55338,139,1323903600,66,4,14,7,91,A,Stanoven%ED%20v%FD%u0161e%20odm%u011Bny%20%u010Dlen%u016Fm%20KR%20GA%20%u010CR
55339,140,1323903600,74,0,12,0,86,A,Labsk%E1%20vodn%ED%20cesta
55340,0,1323990000,0,0,38,0,38,R,32.%20sch%u016Fze%20bude%20pokra%u010Dovat%20v%209%3A00
55341,0,1323990000,113,6,15,7,141,A,Po%u0159ad%20sch%u016Fze
55342,0,1323990000,108,3,27,4,142,A,Po%u0159ad%20sch%u016Fze
55343,98,1323990000,134,1,9,0,144,A,Novela%20z.%20o%20lidsk%FDch%20tk%E1n%EDch%20a%20bu%u0148k%E1ch
55344,98,1323990000,136,1,8,0,145,A,Novela%20z.%20o%20lidsk%FDch%20tk%E1n%EDch%20a%20bu%u0148k%E1ch
55345,99,1323990000,140,3,11,1,155,A,Novela%20z.%20o%20ochran%u011B%20ve%u0159ejn%E9ho%20zdrav%ED
55346,99,1323990000,63,82,10,0,155,R,Novela%20z.%20o%20ochran%u011B%20ve%u0159ejn%E9ho%20zdrav%ED
55347,99,1323990000,67,82,7,0,156,R,Novela%20z.%20o%20ochran%u011B%20ve%u0159ejn%E9ho%20zdrav%ED
55348,99,1323990000,63,87,5,1,156,R,Novela%20z.%20o%20ochran%u011B%20ve%u0159ejn%E9ho%20zdrav%ED
55349,99,1323990000,85,63,5,1,154,A,Novela%20z.%20o%20ochran%u011B%20ve%u0159ejn%E9ho%20zdrav%ED
55350,44,1323990000,56,87,10,0,153,R,Novela%20z.%20-%20ob%u010Dansk%FD%20soudn%ED%20%u0159%E1d
55351,44,1323990000,58,84,11,1,154,R,Novela%20z.%20-%20ob%u010Dansk%FD%20soudn%ED%20%u0159%E1d
55352,44,1323990000,142,2,10,0,154,A,Novela%20z.%20-%20ob%u010Dansk%FD%20soudn%ED%20%u0159%E1d
55353,88,1323990000,128,0,25,0,153,A,Vl.n.z.%20o%20obchodn%EDch%20korporac%EDch%20-%20EU
55354,88,1323990000,111,0,37,4,152,A,Vl.n.z.%20o%20obchodn%EDch%20korporac%EDch%20-%20EU
55355,88,1323990000,85,12,39,17,153,A,Vl.n.z.%20o%20obchodn%EDch%20korporac%EDch%20-%20EU
55356,88,1323990000,35,73,40,6,154,R,Vl.n.z.%20o%20obchodn%EDch%20korporac%EDch%20-%20EU
55357,88,1323990000,82,37,21,15,155,A,Vl.n.z.%20o%20obchodn%EDch%20korporac%EDch%20-%20EU
55358,90,1323990000,130,1,23,0,154,A,Novela%20z.%20o%20uzn%E1v%E1n%ED%20odborn%E9%20kvalifikace%20-%20EU
55359,91,1323990000,129,0,22,3,154,A,Novela%20z.%20o%20uzn%E1v%E1n%ED%20v%FDsledk%u016F%20dal%u0161%EDho%20vzd%u011Bl%E1v%E1n%ED
55360,92,1323990000,133,1,21,0,155,A,Novela%20z.%20o%20ob%u011Bhu%20osiva%20a%20sadby%20-%20EU
55361,93,1323990000,127,0,25,0,152,A,Novela%20z.%20o%20podm%EDnk%E1ch%20p%u0159evodu%20zem%u011Bd%u011Bl.%20a%20lesn%EDch%20pozemk%u016F%20-%20EU
55362,93,1323990000,134,0,18,0,152,A,Novela%20z.%20o%20podm%EDnk%E1ch%20p%u0159evodu%20zem%u011Bd%u011Bl.%20a%20lesn%EDch%20pozemk%u016F%20-%20EU
55363,94,1323990000,130,0,21,0,151,A,Vl.n.z.%20o%20l%E1tk%E1ch%2C%20kter%E9%20po%u0161kozuj%ED%20ozonovou%20vrstvu%20-%20EU
55364,94,1323990000,132,0,19,0,151,A,Vl.n.z.%20o%20l%E1tk%E1ch%2C%20kter%E9%20po%u0161kozuj%ED%20ozonovou%20vrstvu%20-%20EU
55365,96,1323990000,125,3,25,2,155,A,Vl.n.z.%20v%20souvislosti%20s%20reformou%20dohledu%20nad%20fin.%20trhem%20v%20EU%20-%20EU
55366,96,1323990000,127,2,24,2,155,A,Vl.n.z.%20v%20souvislosti%20s%20reformou%20dohledu%20nad%20fin.%20trhem%20v%20EU%20-%20EU
55367,97,1323990000,27,86,29,12,154,R,Novela%20z.%20o%20hospod%E1%u0159sk%FDch%20opat%u0159en%EDch%20pro%20krizov%E9%20stavy
55368,97,1323990000,55,76,21,2,154,R,Novela%20z.%20o%20hospod%E1%u0159sk%FDch%20opat%u0159en%EDch%20pro%20krizov%E9%20stavy
55369,97,1323990000,131,1,21,1,154,A,Novela%20z.%20o%20hospod%E1%u0159sk%FDch%20opat%u0159en%EDch%20pro%20krizov%E9%20stavy
55370,97,1323990000,131,0,22,2,155,A,Novela%20z.%20o%20hospod%E1%u0159sk%FDch%20opat%u0159en%EDch%20pro%20krizov%E9%20stavy
55371,100,1323990000,124,3,26,2,155,A,Novela%20z.%20o%20m%EDstn%EDch%20poplatc%EDch
55372,101,1323990000,125,1,21,7,154,A,Novela%20z.%20o%20obc%EDch
55373,101,1323990000,137,1,18,0,156,A,Novela%20z.%20o%20obc%EDch
55374,101,1323990000,137,1,18,0,156,A,Novela%20z.%20o%20obc%EDch
55375,102,1323990000,108,4,17,7,136,A,Novela%20z.%20o%20%FAprav%u011B%20vlastnick%FDch%20vztah%u016F%20k%20p%u016Fd%u011B
55376,102,1323990000,87,11,24,18,140,A,Novela%20z.%20o%20%FAprav%u011B%20vlastnick%FDch%20vztah%u016F%20k%20p%u016Fd%u011B
55377,102,1323990000,87,52,3,0,142,A,Novela%20z.%20o%20%FAprav%u011B%20vlastnick%FDch%20vztah%u016F%20k%20p%u016Fd%u011B
55378,103,1323990000,41,81,14,8,144,R,Novela%20z.%20o%20rodin%u011B
55379,103,1323990000,129,1,10,4,144,A,Novela%20z.%20o%20rodin%u011B
55380,34,1323990000,121,0,25,0,146,A,Vl.n.z.%20o%20ukl%E1d%E1n%ED%20oxidu%20uhl.%20do%20p%u0159%EDrodn%EDch%20hornin.%20struktur%20-%20EU
55381,34,1323990000,109,0,36,1,146,A,Vl.n.z.%20o%20ukl%E1d%E1n%ED%20oxidu%20uhl.%20do%20p%u0159%EDrodn%EDch%20hornin.%20struktur%20-%20EU
55382,34,1323990000,109,0,36,1,146,A,Vl.n.z.%20o%20ukl%E1d%E1n%ED%20oxidu%20uhl.%20do%20p%u0159%EDrodn%EDch%20hornin.%20struktur%20-%20EU
55383,39,1323990000,86,52,3,2,143,A,N.%20%FAstav.%20z%E1kona%20o%20referendu%20o%20vyrovn%E1n%ED%20s%20c%EDrkvemi
55384,40,1323990000,131,0,12,0,143,A,N.%20%FAstavn%EDho%20z%E1kona%20o%20celost%E1tn%EDm%20referendu
55385,42,1323990000,127,0,18,0,145,A,Novela%20z.%20o%20investi%u010Dn%EDch%20pob%EDdk%E1ch
55386,0,1324335600,138,1,8,3,150,A,Po%u0159ad%20sch%u016Fze
55387,0,1324335600,111,11,23,15,160,A,Po%u0159ad%20sch%u016Fze
55388,0,1324335600,154,0,10,1,165,A,%20
55389,145,1324335600,47,84,17,33,181,R,Novela%20z.%20o%20vzd%u011Bl%E1v%E1n%ED%20-%20%u0161kolsk%FD%20z%E1kon
55390,145,1324335600,171,0,9,2,182,A,Novela%20z.%20o%20vzd%u011Bl%E1v%E1n%ED%20-%20%u0161kolsk%FD%20z%E1kon
55391,146,1324335600,40,114,15,12,181,R,Novela%20z.%20o%20rozhod%u010D%EDm%20%u0159%EDzen%ED
55392,146,1324335600,131,14,14,22,181,A,Novela%20z.%20o%20rozhod%u010D%EDm%20%u0159%EDzen%ED
55393,147,1324335600,162,3,15,1,181,A,Vl.n.z.o%20mezin%E1rodn%ED%20pomoci%20p%u0159i%20vym%E1h%E1n%ED%20fin.pohled%E1vek%20-%20EU
55394,148,1324335600,129,29,18,5,181,A,Novela%20z.%20o%20zru%u0161en%ED%20Fondu%20n%E1rodn%EDho%20majetku
55395,149,1324335600,138,2,37,3,180,A,Vl.n.z.%20v%20souvislosti%20s%20p%u0159ijet%EDm%20z%E1kona%20o%20Celn%ED%20spr%E1v%u011B%20%u010CR
55396,150,1324335600,98,2,26,4,130,A,Vl.n.z.souvisej%EDc%ED%20se%20z%u0159%EDzen%EDm%20jednoho%20inkasn%EDho%20m%EDsta%20-%20EU
55397,55,1324335600,129,0,25,0,154,A,Novela%20z.%20o%20ryb%E1%u0159stv%ED
55398,0,1327964400,84,0,22,0,106,A,%20
55399,0,1327964400,71,33,64,13,181,R,Po%u0159ad%20sch%u016Fze
55400,0,1327964400,119,17,38,11,185,A,Po%u0159ad%20sch%u016Fze
55401,0,1327964400,120,27,20,18,185,A,Po%u0159ad%20sch%u016Fze
55402,0,1327964400,129,29,16,11,185,A,Po%u0159ad%20sch%u016Fze
55403,0,1327964400,112,50,20,3,185,A,Po%u0159ad%20sch%u016Fze
55404,0,1327964400,164,4,15,2,185,A,Po%u0159ad%20sch%u016Fze
55405,0,1327964400,175,2,8,0,185,A,Po%u0159ad%20sch%u016Fze
55406,0,1327964400,128,28,11,18,185,A,Po%u0159ad%20sch%u016Fze
55407,0,1327964400,128,46,9,2,185,A,Po%u0159ad%20sch%u016Fze
55408,0,1327964400,125,45,10,5,185,A,Po%u0159ad%20sch%u016Fze
55409,0,1327964400,80,64,29,11,184,R,Po%u0159ad%20sch%u016Fze
55410,0,1327964400,79,84,16,7,186,R,Po%u0159ad%20sch%u016Fze
55411,0,1327964400,80,75,14,17,186,R,Po%u0159ad%20sch%u016Fze
55412,0,1327964400,78,87,10,11,186,R,Po%u0159ad%20sch%u016Fze
55413,0,1327964400,78,92,9,7,186,R,Po%u0159ad%20sch%u016Fze
55414,0,1327964400,103,29,34,20,186,A,Po%u0159ad%20sch%u016Fze
55415,0,1327964400,103,72,8,3,186,A,Po%u0159ad%20sch%u016Fze
55416,0,1327964400,102,75,5,4,186,A,Po%u0159ad%20sch%u016Fze
55417,0,1327964400,139,7,30,9,185,A,Po%u0159ad%20sch%u016Fze
55418,0,1327964400,102,66,9,9,186,A,Po%u0159ad%20sch%u016Fze
55419,0,1327964400,80,93,10,3,186,R,Po%u0159ad%20sch%u016Fze
55420,0,1327964400,101,74,4,7,186,A,Po%u0159ad%20sch%u016Fze
55421,0,1327964400,79,71,22,14,186,R,Po%u0159ad%20sch%u016Fze
55422,0,1327964400,106,71,6,3,186,A,Po%u0159ad%20sch%u016Fze
55423,0,1327964400,171,0,11,3,185,A,%20
55424,1,1327964400,130,8,4,13,155,A,Vl.n.z.%20o%20podporovan%FDch%20zdroj%EDch%20energie%20-%20EU
55425,2,1327964400,76,102,2,2,182,R,Novela%20z.%20o%20ve%u0159ejn%FDch%20zak%E1zk%E1ch
55426,2,1327964400,107,40,7,28,182,A,Novela%20z.%20o%20ve%u0159ejn%FDch%20zak%E1zk%E1ch
55427,4,1328050800,136,6,0,2,144,A,Vl.n.z.%20o%20ochran%u011B%20ovzdu%u0161%ED%20-%20EU
55428,16,1328050800,137,1,21,2,161,A,Vl%E1dn%ED%20n%E1vrh%20z%E1kona%20o%20z%E1sluh%E1ch%20V%E1clava%20Havla
55429,17,1328050800,94,28,16,16,154,A,Vl.n.z.o%20st%E1tn%EDm%20dluhopisov%E9m%20programu%20na%20rok%202012
55430,17,1328050800,95,24,22,21,162,A,Vl.n.z.o%20st%E1tn%EDm%20dluhopisov%E9m%20programu%20na%20rok%202012
55431,18,1328050800,142,2,21,1,166,A,Novela%20z.%20o%20%FA%u010Detnictv%ED%20-%20EU
55432,19,1328050800,134,1,32,0,167,A,Novela%20z.o%20%FAprav%u011B%20n%u011Bkter%FDch%20vztah%u016F%20v%20oblasti%20ve%u0159ejn%E9%20podpory%20-%20EU
55433,22,1328050800,159,0,18,1,178,A,Novela%20z.%20na%20ochranu%20zv%ED%u0159at%20proti%20t%FDr%E1n%ED%20-%20EU
55434,22,1328050800,84,61,23,10,178,R,Novela%20z.%20na%20ochranu%20zv%ED%u0159at%20proti%20t%FDr%E1n%ED%20-%20EU
55435,16,1328050800,136,23,12,4,175,A,Vl%E1dn%ED%20n%E1vrh%20z%E1kona%20o%20z%E1sluh%E1ch%20V%E1clava%20Havla
55436,16,1328050800,136,16,6,7,165,A,Vl%E1dn%ED%20n%E1vrh%20z%E1kona%20o%20z%E1sluh%E1ch%20V%E1clava%20Havla
55437,25,1328050800,104,0,54,0,158,A,Novela%20z.%20-%20%u017Eivnostensk%FD%20z%E1kon
55438,20,1328050800,128,1,1,0,130,A,Novela%20z.%20o%20%FAzemn%EDm%20pl%E1nov.%20a%20staveb.%20%u0159%E1du%20%28stavebn%ED%20z%E1kon%29%20-%20EU
55439,20,1328050800,118,3,9,1,131,A,Novela%20z.%20o%20%FAzemn%EDm%20pl%E1nov.%20a%20staveb.%20%u0159%E1du%20%28stavebn%ED%20z%E1kon%29%20-%20EU
55440,20,1328050800,113,6,11,2,132,A,Novela%20z.%20o%20%FAzemn%EDm%20pl%E1nov.%20a%20staveb.%20%u0159%E1du%20%28stavebn%ED%20z%E1kon%29%20-%20EU
55441,21,1328050800,122,0,21,0,143,A,Vl.n.z.%20o%20evropsk%E9%20ob%u010Dansk%E9%20iniciativ%u011B%20-%20EU
55442,21,1328050800,120,5,18,0,143,A,Vl.n.z.%20o%20evropsk%E9%20ob%u010Dansk%E9%20iniciativ%u011B%20-%20EU
55443,33,1328050800,123,0,26,0,149,A,Novela%20z.%20o%20archivnictv%ED%20a%20spisov%E9%20slu%u017Eb%u011B
55444,33,1328050800,115,5,27,2,149,A,Novela%20z.%20o%20archivnictv%ED%20a%20spisov%E9%20slu%u017Eb%u011B
55445,31,1328050800,127,0,26,0,153,A,Vl.n.z.%20o%20kontrole%20%28kontroln%ED%20%u0159%E1d%29
55446,23,1328050800,59,70,10,17,156,R,Novela%20z.%20o%20rozpo%u010Dtov%E9m%20ur%u010Den%ED%20dan%ED
55447,23,1328050800,19,92,24,23,158,R,Novela%20z.%20o%20rozpo%u010Dtov%E9m%20ur%u010Den%ED%20dan%ED
55448,23,1328050800,0,1,160,0,161,R,Novela%20z.%20o%20rozpo%u010Dtov%E9m%20ur%u010Den%ED%20dan%ED
55449,23,1328050800,158,3,2,0,163,A,Novela%20z.%20o%20rozpo%u010Dtov%E9m%20ur%u010Den%ED%20dan%ED
55450,23,1328050800,50,74,30,8,162,R,Novela%20z.%20o%20rozpo%u010Dtov%E9m%20ur%u010Den%ED%20dan%ED
55451,23,1328050800,150,6,5,1,162,A,Novela%20z.%20o%20rozpo%u010Dtov%E9m%20ur%u010Den%ED%20dan%ED
55452,23,1328050800,50,73,32,8,163,R,Novela%20z.%20o%20rozpo%u010Dtov%E9m%20ur%u010Den%ED%20dan%ED
55453,23,1328050800,48,81,29,5,163,R,Novela%20z.%20o%20rozpo%u010Dtov%E9m%20ur%u010Den%ED%20dan%ED
55454,23,1328050800,51,80,25,7,163,R,Novela%20z.%20o%20rozpo%u010Dtov%E9m%20ur%u010Den%ED%20dan%ED
55455,23,1328050800,113,38,10,2,163,A,Novela%20z.%20o%20rozpo%u010Dtov%E9m%20ur%u010Den%ED%20dan%ED
55456,76,1328137200,40,43,17,2,102,R,P%EDsemn%E1%20interpelace%20H.%20Orgon%EDkov%E9%20na%20J.%20Kubiceho%20ve%20v%u011Bci%20%FAsporn%FDch%20opa
55457,76,1328137200,51,44,0,1,96,A,P%EDsemn%E1%20interpelace%20M.%20Greben%ED%u010Dka%20na%20P.%20Ne%u010Dase%20ve%20v%u011Bci%20podez%u0159en%ED%2C%20%u017Ee%20v
55458,26,1328137200,87,1,18,0,106,A,Vl.n.%FAstav.z.%20o%20zm%u011Bn%E1ch%20st%E1tn%EDch%20hranic%20s%20Rakouskou%20rep.
55459,48,1328137200,91,1,20,0,112,A,Sml.mezi%20%u010CR%20a%20Rak.rep.o%20zm%u011Bn%E1ch%20pr%u016Fb%u011Bhu%20spol.st%E1tn%EDch%20hranic
55460,48,1328137200,93,0,23,0,116,A,Sml.mezi%20%u010CR%20a%20Rak.rep.o%20zm%u011Bn%E1ch%20pr%u016Fb%u011Bhu%20spol.st%E1tn%EDch%20hranic
55461,41,1328137200,92,1,27,0,120,A,Doh.%20mezi%20%u010CR%20a%20Jersey%20o%20v%FDm%u011Bn%u011B%20inf.%20v%20da%u0148.%20z%E1le%u017Eitostech
55462,42,1328137200,101,0,21,0,122,A,Doh.%20mezi%20%u010CR%20a%20vl.%20Bermud%20o%20v%FDm%u011Bn%u011B%20inf.%20v%20da%u0148.%20z%E1le%u017Eitostech
55463,43,1328137200,104,0,23,0,127,A,Sml.%20mezi%20%u010CR%20a%20D%E1nsk%FDm%20kr%E1l.%20o%20zamezen%ED%20dvoj.%20zdan%u011Bn%ED
55464,44,1328137200,93,0,38,0,131,A,%DAml.%20o%20mezin%E1r.%20ochran%u011B%20dosp%u011Bl%FDch%20osob
55465,45,1328137200,95,0,37,0,132,A,Sml.%20mezi%20%u010CR%20a%20vl.%20Barbadosu%20o%20zamezen%ED%20dvoj%EDmu%20zdan%u011Bn%ED
55466,46,1328137200,94,0,37,0,131,A,Doh.%20mezi%20%u010CR%20a%20vl.%20Rep.%20Uzbekist%E1n%20o%20leteck%FDch%20slu%u017Eb%E1ch
55467,47,1328137200,104,1,28,0,133,A,Sml.mezi%20%u010CR%20a%20Estonskou%20rep.o%20ochran%u011B%20utaj.%20informac%ED
55468,49,1328137200,102,0,33,0,135,A,Sml.%20mezi%20%u010CR%20a%20Moldavskou%20rep.%20o%20soci%E1ln%EDm%20zabezpe%u010Den%ED
55469,50,1328137200,111,1,25,0,137,A,Prot.%20mezi%20%u010CR%20a%20vl.%20Uzbeck%E9%20rep.%20o%20zamezen%ED%20dvoj%EDho%20zdan%u011Bn%ED
55470,52,1328137200,104,0,33,0,137,A,Sml.mezi%20%u010CR%20a%20Ruskou%20federac%ED%20o%20soci%E1ln%EDm%20zabezpe%u010Den%ED
55471,53,1328137200,110,0,28,0,138,A,Doh.%20mezi%20%u010CR%20a%20Rep.%20San%20Marino%20o%20v%FDm%u011Bn%u011B%20inf.%20v%20da%u0148.%20z%E1le%u017Eit.
55472,24,1328137200,104,6,29,0,139,A,Novela%20z.%20o%20odpov%u011Bdnosti%20za%20%u0161kodu%20zp%u016Fs.p%u0159i%20v%FDkonu%20ve%u0159ej.moci
55473,24,1328137200,108,6,26,1,141,A,Novela%20z.%20o%20odpov%u011Bdnosti%20za%20%u0161kodu%20zp%u016Fs.p%u0159i%20v%FDkonu%20ve%u0159ej.moci
55474,28,1328137200,110,0,32,0,142,A,Novela%20z.%20o%20zaji%u0161t%u011Bn%ED%20bezpe%u010Dnosti%20a%20ochr.%20zdrav%ED%20p%u0159i%20pr%E1ci
55475,28,1328137200,102,0,40,0,142,A,Novela%20z.%20o%20zaji%u0161t%u011Bn%ED%20bezpe%u010Dnosti%20a%20ochr.%20zdrav%ED%20p%u0159i%20pr%E1ci
55476,29,1328137200,109,1,33,0,143,A,Novela%20z.%20o%20soci%E1ln%u011B-pr%E1vn%ED%20ochran%u011B%20d%u011Bt%ED
55477,29,1328137200,59,36,35,13,143,R,Novela%20z.%20o%20soci%E1ln%u011B-pr%E1vn%ED%20ochran%u011B%20d%u011Bt%ED
55478,29,1328137200,81,21,37,4,143,A,Novela%20z.%20o%20soci%E1ln%u011B-pr%E1vn%ED%20ochran%u011B%20d%u011Bt%ED
55479,29,1328137200,104,4,32,3,143,A,Novela%20z.%20o%20soci%E1ln%u011B-pr%E1vn%ED%20ochran%u011B%20d%u011Bt%ED
55480,0,1328223600,81,9,15,2,107,A,Po%u0159ad%20sch%u016Fze
55481,0,1328223600,83,9,15,4,111,A,Po%u0159ad%20sch%u016Fze
55482,32,1328223600,77,77,0,1,155,R,Vl.n.z.%20o%20majetkov%E9m%20vyrovn%E1n%ED%20s%20c%EDrkvemi%20a%20n%E1bo%u017Een.%20spole%u010D.
55483,0,1328569200,146,0,9,0,155,A,%20
55484,0,1328569200,153,1,9,0,163,A,%20
55485,0,1328569200,123,17,11,13,164,A,Po%u0159ad%20sch%u016Fze
55486,0,1328569200,109,23,17,16,165,A,Po%u0159ad%20sch%u016Fze
55487,0,1328569200,155,1,9,1,166,A,Po%u0159ad%20sch%u016Fze
55488,0,1328569200,115,13,36,7,171,A,Po%u0159ad%20sch%u016Fze
55489,0,1328569200,73,69,23,12,177,R,Po%u0159ad%20sch%u016Fze
55490,0,1328569200,73,84,15,8,180,R,Po%u0159ad%20sch%u016Fze
55491,0,1328569200,76,89,11,5,181,R,Po%u0159ad%20sch%u016Fze
55492,0,1328569200,10,104,46,21,181,R,Po%u0159ad%20sch%u016Fze
55493,0,1328569200,164,4,10,3,181,A,Po%u0159ad%20sch%u016Fze
55494,0,1328569200,95,72,10,4,181,A,Po%u0159ad%20sch%u016Fze
55495,0,1328569200,97,74,6,4,181,A,Po%u0159ad%20sch%u016Fze
55496,4,1328569200,106,31,37,3,177,A,Vl.n.z.%20o%20ochran%u011B%20ovzdu%u0161%ED%20-%20EU
55497,40,1328569200,131,3,39,2,175,A,V%u0161eobecn%E9%20dohody%20o%20obchodu%20a%20slu%u017Eb%E1ch%20%28GATS%29
55498,39,1328569200,127,2,47,0,176,A,Doh.%20mezi%20%u010CR%20a%20Organizac%ED%20pro%20z%E1kaz%20chemick%FDch%20zbran%ED
55499,14,1328569200,90,25,60,2,177,A,Novela%20z.%20o%20voj%E1c%EDch%20z%20povol%E1n%ED
55500,54,1328569200,132,0,46,0,178,A,Doh.mezi%20%u010CR%20a%20vl%20Korejsk%E9%20rep.%20o%20programu%20pracovn%ED%20dovolen%E9
55501,54,1328569200,123,3,48,5,179,A,Doh.mezi%20%u010CR%20a%20vl%20Korejsk%E9%20rep.%20o%20programu%20pracovn%ED%20dovolen%E9
55502,27,1328569200,141,0,40,0,181,A,Novela%20z.%20o%20ozbrojen%FDch%20sil%E1ch%20%u010Cesk%E9%20republiky
55503,27,1328569200,57,71,47,6,181,R,Novela%20z.%20o%20ozbrojen%FDch%20sil%E1ch%20%u010Cesk%E9%20republiky
55504,27,1328569200,47,74,49,11,181,R,Novela%20z.%20o%20ozbrojen%FDch%20sil%E1ch%20%u010Cesk%E9%20republiky
55505,34,1328569200,79,47,12,6,144,A,Novela%20z.%20o%20obc%EDch
55506,36,1328569200,106,40,0,2,148,A,N.z.%20o%20soci%E1ln%EDm%20bydlen%ED
55507,37,1328569200,100,39,11,0,150,A,Novela%20z.%20o%20loteri%EDch
55508,38,1328569200,101,37,13,0,151,A,Novela%20z.%20-%20trestn%ED%20z%E1kon%EDk
55509,0,1328569200,128,2,25,2,157,A,%20
55510,78,1328569200,161,4,12,0,177,A,Novela%20z.%20o%20lidsk%FDch%20tk%E1n%EDch%20a%20bu%u0148k%E1ch
55511,79,1328569200,157,9,7,6,179,A,Novela%20z.%20o%20obc%EDch
55512,80,1328569200,150,25,6,0,181,A,Novela%20z.%20o%20%FAprav%u011B%20vlastnick%FDch%20vztah%u016F%20k%20p%u016Fd%u011B
55513,81,1328569200,68,93,19,3,183,R,Novela%20z.%20o%20hospod%E1%u0159sk%FDch%20opat%u0159en%EDch%20pro%20krizov%E9%20stavy
55514,81,1328569200,161,4,14,4,183,A,Novela%20z.%20o%20hospod%E1%u0159sk%FDch%20opat%u0159en%EDch%20pro%20krizov%E9%20stavy
55515,82,1328569200,168,0,14,0,182,A,Novela%20z.%20o%20podm%EDnk%E1ch%20p%u0159evodu%20zem%u011Bd%u011Bl.%20a%20lesn%EDch%20pozemk%u016F%20-%20EU
55516,83,1328569200,155,0,27,1,183,A,Vl.n.z.%20o%20l%E1tk%E1ch%2C%20kter%E9%20po%u0161kozuj%ED%20ozonovou%20vrstvu%20-%20EU
55517,84,1328569200,99,65,18,1,183,A,Novela%20z.%20o%20ochran%u011B%20ve%u0159ejn%E9ho%20zdrav%ED
55518,85,1328569200,24,127,27,6,184,R,Novela%20z.%20o%20rodin%u011B
55519,85,1328569200,159,0,24,1,184,A,Novela%20z.%20o%20rodin%u011B
55520,86,1328569200,141,0,41,3,185,A,Vl.n.z.%20o%20ukl%E1d%E1n%ED%20oxidu%20uhl.%20do%20p%u0159%EDrodn%EDch%20hornin.%20struktur%20-%20EU
55521,32,1328569200,76,98,5,1,180,R,Vl.n.z.%20o%20majetkov%E9m%20vyrovn%E1n%ED%20s%20c%EDrkvemi%20a%20n%E1bo%u017Een.%20spole%u010D.
55522,32,1328569200,8,15,158,0,181,R,Vl.n.z.%20o%20majetkov%E9m%20vyrovn%E1n%ED%20s%20c%EDrkvemi%20a%20n%E1bo%u017Een.%20spole%u010D.
55523,32,1328569200,75,100,0,3,178,R,Vl.n.z.%20o%20majetkov%E9m%20vyrovn%E1n%ED%20s%20c%EDrkvemi%20a%20n%E1bo%u017Een.%20spole%u010D.
55524,32,1328569200,176,1,1,1,179,A,Vl.n.z.%20o%20majetkov%E9m%20vyrovn%E1n%ED%20s%20c%EDrkvemi%20a%20n%E1bo%u017Een.%20spole%u010D.
55525,32,1328569200,81,82,4,12,179,R,Vl.n.z.%20o%20majetkov%E9m%20vyrovn%E1n%ED%20s%20c%EDrkvemi%20a%20n%E1bo%u017Een.%20spole%u010D.
55526,32,1328569200,82,87,3,7,179,R,Vl.n.z.%20o%20majetkov%E9m%20vyrovn%E1n%ED%20s%20c%EDrkvemi%20a%20n%E1bo%u017Een.%20spole%u010D.
55527,32,1328569200,81,88,3,7,179,R,Vl.n.z.%20o%20majetkov%E9m%20vyrovn%E1n%ED%20s%20c%EDrkvemi%20a%20n%E1bo%u017Een.%20spole%u010D.
55528,32,1328569200,78,92,4,2,176,R,Vl.n.z.%20o%20majetkov%E9m%20vyrovn%E1n%ED%20s%20c%EDrkvemi%20a%20n%E1bo%u017Een.%20spole%u010D.
55529,0,1328655600,71,81,3,6,161,R,Po%u0159ad%20sch%u016Fze
55530,58,1328655600,160,0,10,1,171,A,Novela%20z.%20o%20silni%u010Dn%ED%20doprav%u011B%20-%20EU
55531,58,1328655600,164,1,7,1,173,A,Novela%20z.%20o%20silni%u010Dn%ED%20doprav%u011B%20-%20EU
55532,58,1328655600,167,0,7,0,174,A,Novela%20z.%20o%20silni%u010Dn%ED%20doprav%u011B%20-%20EU
55533,58,1328655600,144,0,29,2,175,A,Novela%20z.%20o%20silni%u010Dn%ED%20doprav%u011B%20-%20EU
55534,59,1328655600,75,86,5,3,169,R,Novela%20z.%20o%20pozemn%EDch%20komunikac%EDch%20-%20EU
55535,59,1328655600,65,76,12,19,172,R,Novela%20z.%20o%20pozemn%EDch%20komunikac%EDch%20-%20EU
55536,59,1328655600,138,6,24,5,173,A,Novela%20z.%20o%20pozemn%EDch%20komunikac%EDch%20-%20EU
55537,59,1328655600,171,0,1,1,173,A,Novela%20z.%20o%20pozemn%EDch%20komunikac%EDch%20-%20EU
55538,59,1328655600,76,92,3,1,172,R,Novela%20z.%20o%20pozemn%EDch%20komunikac%EDch%20-%20EU
55539,59,1328655600,75,92,3,3,173,R,Novela%20z.%20o%20pozemn%EDch%20komunikac%EDch%20-%20EU
55540,59,1328655600,143,19,3,8,173,A,Novela%20z.%20o%20pozemn%EDch%20komunikac%EDch%20-%20EU
55541,59,1328655600,26,110,8,29,173,R,Novela%20z.%20o%20pozemn%EDch%20komunikac%EDch%20-%20EU
55542,59,1328655600,77,93,2,1,173,R,Novela%20z.%20o%20pozemn%EDch%20komunikac%EDch%20-%20EU
55543,59,1328655600,42,94,27,9,172,R,Novela%20z.%20o%20pozemn%EDch%20komunikac%EDch%20-%20EU
55544,59,1328655600,120,43,4,6,173,A,Novela%20z.%20o%20pozemn%EDch%20komunikac%EDch%20-%20EU
55545,59,1328655600,111,18,24,15,168,A,Novela%20z.%20o%20pozemn%EDch%20komunikac%EDch%20-%20EU
55546,64,1328655600,158,0,2,4,164,A,Novela%20z.%20-%20%DAstava%20%u010Cesk%E9%20republiky
55547,64,1328655600,156,0,2,3,161,A,Novela%20z.%20-%20%DAstava%20%u010Cesk%E9%20republiky
55548,57,1328655600,163,0,9,0,172,A,Novela%20z.%20o%20rostlinol%E9ka%u0159sk%E9%20p%E9%u010Di%20-%20EU
55549,57,1328655600,160,0,11,1,172,A,Novela%20z.%20o%20rostlinol%E9ka%u0159sk%E9%20p%E9%u010Di%20-%20EU
55550,57,1328655600,25,89,35,23,172,R,Novela%20z.%20o%20rostlinol%E9ka%u0159sk%E9%20p%E9%u010Di%20-%20EU
55551,57,1328655600,165,0,8,0,173,A,Novela%20z.%20o%20rostlinol%E9ka%u0159sk%E9%20p%E9%u010Di%20-%20EU
55552,60,1328655600,105,23,21,24,173,A,Novela%20z.%20o%20provozu%20na%20pozemn%EDch%20komunikac%EDch
55553,60,1328655600,47,81,35,9,172,R,Novela%20z.%20o%20provozu%20na%20pozemn%EDch%20komunikac%EDch
55554,60,1328655600,112,35,17,8,172,A,Novela%20z.%20o%20provozu%20na%20pozemn%EDch%20komunikac%EDch
55555,60,1328655600,90,53,21,9,173,A,Novela%20z.%20o%20provozu%20na%20pozemn%EDch%20komunikac%EDch
55556,60,1328655600,153,2,3,2,160,A,Novela%20z.%20o%20provozu%20na%20pozemn%EDch%20komunikac%EDch
55557,60,1328655600,85,56,11,9,161,A,Novela%20z.%20o%20provozu%20na%20pozemn%EDch%20komunikac%EDch
55558,61,1328655600,149,0,10,0,159,A,Novela%20z.%20o%20pedagogick%FDch%20pracovn%EDc%EDch
55559,61,1328655600,149,0,11,0,160,A,Novela%20z.%20o%20pedagogick%FDch%20pracovn%EDc%EDch
55560,61,1328655600,157,0,5,0,162,A,Novela%20z.%20o%20pedagogick%FDch%20pracovn%EDc%EDch
55561,62,1328655600,66,27,39,18,150,R,Novela%20z.%20o%20m%EDstn%EDch%20poplatc%EDch
55562,62,1328655600,123,4,10,4,141,A,Novela%20z.%20o%20m%EDstn%EDch%20poplatc%EDch
55563,62,1328655600,82,35,10,15,142,A,Novela%20z.%20o%20m%EDstn%EDch%20poplatc%EDch
55564,62,1328655600,77,42,11,16,146,A,Novela%20z.%20o%20m%EDstn%EDch%20poplatc%EDch
55565,63,1328655600,86,43,12,10,151,A,Novela%20z.%20o%20p%u0159estupc%EDch
55566,65,1328655600,142,2,11,2,157,A,Novela%20z.%20o%20ve%u0159ejn%FDch%20sb%EDrk%E1ch
55567,65,1328655600,149,1,8,1,159,A,Novela%20z.%20o%20ve%u0159ejn%FDch%20sb%EDrk%E1ch
55568,67,1328655600,149,0,12,0,161,A,Novela%20z.%2C%20kter%FDm%20se%20zm%EDr%u0148uj%ED%20majetkov%E9%20k%u0159ivdy%20ob%u010Dan%u016Fm%20%u010CR
55569,67,1328655600,152,0,9,1,162,A,Novela%20z.%2C%20kter%FDm%20se%20zm%EDr%u0148uj%ED%20majetkov%E9%20k%u0159ivdy%20ob%u010Dan%u016Fm%20%u010CR
55570,67,1328655600,153,0,9,0,162,A,Novela%20z.%2C%20kter%FDm%20se%20zm%EDr%u0148uj%ED%20majetkov%E9%20k%u0159ivdy%20ob%u010Dan%u016Fm%20%u010CR
55571,30,1328655600,140,0,22,1,163,A,Novela%20z.%20o%20v%FDkonu%20%FAstavn%ED%20v%FDchovy
55572,30,1328655600,119,11,25,8,163,A,Novela%20z.%20o%20v%FDkonu%20%FAstavn%ED%20v%FDchovy
55573,30,1328655600,125,14,23,1,163,A,Novela%20z.%20o%20v%FDkonu%20%FAstavn%ED%20v%FDchovy
55574,73,1328655600,126,0,32,1,159,A,N%E1vrh%20Pravidel%20hospoda%u0159en%ED%20poslaneck%FDch%20klub%u016F%20pro%20rok%202012
55575,74,1328655600,132,1,26,0,159,A,N%E1vrh%20na%20zm%u011Bnu%20n%E1zvu%20SK%20PS%20pro%20kontrolu%20pou%u017Eit%ED%20odposlechu
55576,0,1328742000,116,0,13,0,129,A,%20
55577,0,1328742000,68,81,11,2,162,R,Po%u0159ad%20sch%u016Fze
55578,0,1328742000,80,0,12,0,92,A,%20
55579,0,1328742000,56,80,5,0,141,R,%20
55580,75,1328742000,76,30,29,3,138,A,Informace%20p%u0159edsedy%20vl%E1dy%20o%20jedn%E1n%ED%20ER%20dne%2030.%20ledna%202012
55581,75,1328742000,32,44,42,19,137,R,Informace%20p%u0159edsedy%20vl%E1dy%20o%20jedn%E1n%ED%20ER%20dne%2030.%20ledna%202012
55582,68,1328742000,101,3,32,1,137,A,Volba%20%u010Dlen%u016F%20Etick%E9%20komise%20%u010CR%20pro%20ocen%u011Bn%ED%20%FA%u010Dastn%EDk%u016F%20odboje
55583,69,1328742000,105,0,33,2,140,A,N%E1vrh%20na%20zm%u011Bny%20ve%20slo%u017Een%ED%20org%E1n%u016F%20Poslaneck%E9%20sn%u011Bmovny
55584,69,1328742000,90,2,37,6,135,A,N%E1vrh%20na%20zm%u011Bny%20ve%20slo%u017Een%ED%20org%E1n%u016F%20Poslaneck%E9%20sn%u011Bmovny
55585,69,1328742000,69,4,48,14,135,A,N%E1vrh%20na%20zm%u011Bny%20ve%20slo%u017Een%ED%20org%E1n%u016F%20Poslaneck%E9%20sn%u011Bmovny
55586,69,1328742000,106,0,33,1,140,A,N%E1vrh%20na%20zm%u011Bny%20ve%20slo%u017Een%ED%20org%E1n%u016F%20Poslaneck%E9%20sn%u011Bmovny
55587,69,1328742000,106,0,34,0,140,A,N%E1vrh%20na%20zm%u011Bny%20ve%20slo%u017Een%ED%20org%E1n%u016F%20Poslaneck%E9%20sn%u011Bmovny
55588,0,1328742000,46,59,6,1,112,R,Po%u0159ad%20sch%u016Fze
55589,0,1328828400,114,1,9,16,140,A,Po%u0159ad%20sch%u016Fze
55590,0,1328828400,78,28,18,14,138,A,Po%u0159ad%20sch%u016Fze
55591,0,1328828400,83,33,16,10,142,A,Po%u0159ad%20sch%u016Fze
55592,0,1328828400,69,40,12,19,140,R,Po%u0159ad%20sch%u016Fze
55593,0,1328828400,65,25,30,19,139,R,Po%u0159ad%20sch%u016Fze
55594,66,1328828400,144,0,6,0,150,A,Novela%20z.%20o%20voj%E1c%EDch%20z%20povol%E1n%ED
55595,66,1328828400,60,82,6,2,150,R,Novela%20z.%20o%20voj%E1c%EDch%20z%20povol%E1n%ED
55596,66,1328828400,144,0,6,0,150,A,Novela%20z.%20o%20voj%E1c%EDch%20z%20povol%E1n%ED
55597,66,1328828400,102,37,9,2,150,A,Novela%20z.%20o%20voj%E1c%EDch%20z%20povol%E1n%ED
55598,70,1328828400,125,1,22,0,148,A,Inf.o%20voj.cvi%u010D.A%u010CR%20se%20zahr.partnery%20v%20roce%202012
55599,71,1328828400,77,57,1,1,136,A,3.dopln%u011Bk%20pl%E1nu%20voj.cvi%u010Den%ED%20A%u010CR%20se%20zahr.partnery%20v%20roce%202011
55600,72,1328828400,87,20,25,1,133,A,Rozh.vl.%20o%20p%u0159eletech%20a%20pr%u016Fj.ozbroj.sil%20p%u0159es%20%FAzem%ED%20%u010CR%20-%202012
55601,56,1328828400,140,0,4,2,146,A,Vl.n.z.%20o%20ochran%u011B%20ovzdu%u0161%ED%20-%20EU
55602,56,1328828400,144,0,2,0,146,A,Vl.n.z.%20o%20ochran%u011B%20ovzdu%u0161%ED%20-%20EU
55603,56,1328828400,127,14,2,3,146,A,Vl.n.z.%20o%20ochran%u011B%20ovzdu%u0161%ED%20-%20EU
55604,56,1328828400,77,53,8,7,145,A,Vl.n.z.%20o%20ochran%u011B%20ovzdu%u0161%ED%20-%20EU
55605,56,1328828400,134,3,5,4,146,A,Vl.n.z.%20o%20ochran%u011B%20ovzdu%u0161%ED%20-%20EU
55606,56,1328828400,8,77,22,39,146,R,Vl.n.z.%20o%20ochran%u011B%20ovzdu%u0161%ED%20-%20EU
55607,56,1328828400,144,0,2,0,146,A,Vl.n.z.%20o%20ochran%u011B%20ovzdu%u0161%ED%20-%20EU
55608,56,1328828400,143,0,2,1,146,A,Vl.n.z.%20o%20ochran%u011B%20ovzdu%u0161%ED%20-%20EU
55609,56,1328828400,142,0,3,1,146,A,Vl.n.z.%20o%20ochran%u011B%20ovzdu%u0161%ED%20-%20EU
55610,56,1328828400,143,0,3,0,146,A,Vl.n.z.%20o%20ochran%u011B%20ovzdu%u0161%ED%20-%20EU
55611,56,1328828400,142,1,3,0,146,A,Vl.n.z.%20o%20ochran%u011B%20ovzdu%u0161%ED%20-%20EU
55612,56,1328828400,144,0,2,0,146,A,Vl.n.z.%20o%20ochran%u011B%20ovzdu%u0161%ED%20-%20EU
55613,56,1328828400,142,0,4,0,146,A,Vl.n.z.%20o%20ochran%u011B%20ovzdu%u0161%ED%20-%20EU
55614,56,1328828400,142,0,3,1,146,A,Vl.n.z.%20o%20ochran%u011B%20ovzdu%u0161%ED%20-%20EU
55615,56,1328828400,142,0,4,0,146,A,Vl.n.z.%20o%20ochran%u011B%20ovzdu%u0161%ED%20-%20EU
55616,56,1328828400,106,9,11,20,146,A,Vl.n.z.%20o%20ochran%u011B%20ovzdu%u0161%ED%20-%20EU
55617,56,1328828400,55,52,17,22,146,R,Vl.n.z.%20o%20ochran%u011B%20ovzdu%u0161%ED%20-%20EU
55618,55,1328828400,32,81,4,6,123,R,Vl.n.z.%20o%20mediaci%20-%20EU
55619,55,1328828400,129,0,2,0,131,A,Vl.n.z.%20o%20mediaci%20-%20EU
55620,55,1328828400,2,2,131,0,135,R,Vl.n.z.%20o%20mediaci%20-%20EU
55621,55,1328828400,79,49,5,3,136,A,Vl.n.z.%20o%20mediaci%20-%20EU
55622,55,1328828400,21,85,23,7,136,R,Vl.n.z.%20o%20mediaci%20-%20EU
55623,55,1328828400,60,67,5,4,136,R,Vl.n.z.%20o%20mediaci%20-%20EU
55624,55,1328828400,130,1,5,0,136,A,Vl.n.z.%20o%20mediaci%20-%20EU
55625,55,1328828400,125,3,3,2,133,A,Vl.n.z.%20o%20mediaci%20-%20EU
55626,0,1331593200,92,0,23,1,116,A,%20
55627,0,1331593200,103,52,23,6,184,A,Po%u0159ad%20sch%u016Fze
55628,0,1331593200,169,7,4,4,184,A,Po%u0159ad%20sch%u016Fze
55629,0,1331593200,56,102,10,15,183,R,Po%u0159ad%20sch%u016Fze
55630,0,1331593200,78,101,2,3,184,R,Po%u0159ad%20sch%u016Fze
55631,0,1331593200,75,97,8,4,184,R,Po%u0159ad%20sch%u016Fze
55632,0,1331593200,74,102,5,3,184,R,Po%u0159ad%20sch%u016Fze
55633,0,1331593200,104,38,28,14,184,A,Po%u0159ad%20sch%u016Fze
55634,0,1331593200,76,100,4,4,184,R,Po%u0159ad%20sch%u016Fze
55635,0,1331593200,78,96,7,3,184,R,Po%u0159ad%20sch%u016Fze
55636,0,1331593200,79,100,5,0,184,R,Po%u0159ad%20sch%u016Fze
55637,0,1331593200,77,102,5,0,184,R,Po%u0159ad%20sch%u016Fze
55638,0,1331593200,77,85,10,12,184,R,Po%u0159ad%20sch%u016Fze
55639,0,1331593200,131,39,10,4,184,A,Po%u0159ad%20sch%u016Fze
55640,0,1331593200,76,100,6,2,184,R,Po%u0159ad%20sch%u016Fze
55641,0,1331593200,105,70,5,4,184,A,Po%u0159ad%20sch%u016Fze
55642,0,1331593200,98,74,8,2,182,A,Po%u0159ad%20sch%u016Fze
55643,1,1331593200,99,24,40,16,179,A,N%E1vrh%20na%20zkr%E1cen%ED%20z%E1konn%E9%20lh%u016Fty%20sn%u011Bmovn%EDho%20tisku%20547
55644,19,1331593200,121,0,60,0,181,A,N.z.%20o%20ob%u011Btech%20trestn%FDch%20%u010Din%u016F%20-%20EU
55645,20,1331593200,104,0,76,0,180,A,Novela%20z.%20o%20hospoda%u0159en%ED%20energi%ED%20-%20EU
55646,22,1331593200,124,1,1,0,126,A,Novela%20z.%20o%20poskytov%E1n%ED%20d%E1vek%20osob%E1m%20se%20zdrav.%20posti%u017Een%EDm
55647,22,1331593200,130,1,2,2,135,A,Novela%20z.%20o%20poskytov%E1n%ED%20d%E1vek%20osob%E1m%20se%20zdrav.%20posti%u017Een%EDm
55648,22,1331593200,68,41,10,20,139,R,Novela%20z.%20o%20poskytov%E1n%ED%20d%E1vek%20osob%E1m%20se%20zdrav.%20posti%u017Een%EDm
55649,23,1331593200,144,0,1,0,145,A,Novela%20z.%20o%20poskytov%E1n%ED%20d%E1vek%20osob%E1m%20se%20zdrav.%20posti%u017Een%EDm
55650,23,1331593200,147,0,2,0,149,A,Novela%20z.%20o%20poskytov%E1n%ED%20d%E1vek%20osob%E1m%20se%20zdrav.%20posti%u017Een%EDm
55651,24,1331593200,95,72,0,0,167,A,Novela%20z.%20o%20d%u016Fchodov%E9m%20spo%u0159en%ED
55652,25,1331593200,153,2,8,0,163,A,Novela%20z.%20o%20st%E1tn%ED%20soci%E1ln%ED%20podpo%u0159e
55653,0,1331679600,101,15,6,14,136,A,Po%u0159ad%20sch%u016Fze
55654,0,1331679600,127,1,11,2,141,A,Po%u0159ad%20sch%u016Fze
55655,0,1331679600,136,0,7,2,145,A,Po%u0159ad%20sch%u016Fze
55656,0,1331679600,141,3,6,2,152,A,Po%u0159ad%20sch%u016Fze
55657,0,1331679600,134,3,14,4,155,A,Po%u0159ad%20sch%u016Fze
55658,34,1331679600,130,1,34,0,165,A,Novela%20z.%20o%20spr%E1vn%EDch%20poplatc%EDch
55659,18,1331679600,153,1,25,0,179,A,Novela%20z.%20o%20elektronick%FDch%20komunikac%EDch%20-%20EU
55660,26,1331679600,135,7,25,12,179,A,N.z.o%20zm%u011Bn%u011B%20z%E1kon%u016F%20v%20souvislosti%20se%20zaveden%EDm%20z%E1kl.%20registr%u016F
55661,26,1331679600,119,25,26,8,178,A,N.z.o%20zm%u011Bn%u011B%20z%E1kon%u016F%20v%20souvislosti%20se%20zaveden%EDm%20z%E1kl.%20registr%u016F
55662,33,1331679600,146,1,34,0,181,A,N.z.%20o%20volb%u011B%20prezidenta%20republiky
55663,21,1331679600,137,0,46,0,183,A,Vl.%20n.%20z.%2C%20kter%FDm%20se%20m%u011Bn%ED%20volebn%ED%20z%E1kony%20-%20EU
55664,21,1331679600,78,32,60,13,183,R,Vl.%20n.%20z.%2C%20kter%FDm%20se%20m%u011Bn%ED%20volebn%ED%20z%E1kony%20-%20EU
55665,21,1331679600,136,3,12,2,153,A,Vl.%20n.%20z.%2C%20kter%FDm%20se%20m%u011Bn%ED%20volebn%ED%20z%E1kony%20-%20EU
55666,21,1331679600,99,32,21,6,158,A,Vl.%20n.%20z.%2C%20kter%FDm%20se%20m%u011Bn%ED%20volebn%ED%20z%E1kony%20-%20EU
55667,17,1331679600,68,89,13,4,174,R,Novela%20z.%20o%20finan%u010Dn%ED%20kontrole%20-%20EU
55668,17,1331679600,160,2,13,0,175,A,Novela%20z.%20o%20finan%u010Dn%ED%20kontrole%20-%20EU
55669,17,1331679600,121,23,18,14,176,A,Novela%20z.%20o%20finan%u010Dn%ED%20kontrole%20-%20EU
55670,17,1331679600,94,40,27,14,175,A,Novela%20z.%20o%20finan%u010Dn%ED%20kontrole%20-%20EU
55671,17,1331679600,163,1,12,0,176,A,Novela%20z.%20o%20finan%u010Dn%ED%20kontrole%20-%20EU
55672,27,1331679600,81,67,3,1,152,A,N.%20%FAstavn%EDho%20z%E1kona%20o%20celost%E1tn%EDm%20referendu
55673,28,1331679600,135,1,26,0,162,A,Novela%20z.%20-%20trestn%ED%20z%E1kon%EDk
55674,0,1331679600,84,1,71,1,157,A,%20
55675,2,1331679600,85,51,12,10,158,A,Novela%20z.%20o%20ochran%u011B%20ve%u0159ejn%E9ho%20zdrav%ED
55676,29,1331679600,114,3,45,2,164,A,Novela%20z.%20o%20p%u0159estupc%EDch
55677,29,1331679600,71,52,26,11,160,R,Novela%20z.%20o%20p%u0159estupc%EDch
55678,29,1331679600,154,0,7,2,163,A,Novela%20z.%20o%20p%u0159estupc%EDch
55679,0,1331766000,70,1,11,6,88,A,Po%u0159ad%20sch%u016Fze
55680,0,1331766000,44,11,27,9,91,R,Po%u0159ad%20sch%u016Fze
55681,0,1331766000,67,0,20,3,90,A,%20
55682,0,1331766000,65,7,18,4,94,A,Po%u0159ad%20sch%u016Fze
55683,0,1331766000,64,7,22,2,95,A,Po%u0159ad%20sch%u016Fze
55684,0,1331766000,63,8,22,3,96,A,Po%u0159ad%20sch%u016Fze
55685,69,1331766000,49,52,1,0,102,R,P%EDsemn%E1%20interpelace%20G.%20Hub%E1%u010Dkov%E9%20na%20L.%20Hegera%20ve%20v%u011Bci%20%FAhrady%20centrov%E9
55686,69,1331766000,80,1,28,4,113,A,P%EDsemn%E1%20interpelace%20H.%20Orgon%EDkov%E9%20na%20L.%20Hegera%20ve%20v%u011Bci%20iktov%E9ho%20centra
55687,45,1331766000,81,0,33,1,115,A,Doh.mezi%20%u010CR%20a%20vl%20Korejsk%E9%20rep.%20o%20programu%20pracovn%ED%20dovolen%E9
55688,47,1331766000,96,1,28,1,126,A,Sml.%20o%20p%u0159istoupen%ED%20Chorvatsk%E9%20republiky%20k%20Evropsk%E9%20unii
55689,41,1331766000,100,0,25,0,125,A,Doh.mezi%20%u010CR%20a%20Ostrovem%20Man%20o%20v%FDm%u011Bn%u011B%20inf.v%20da%u0148.z%E1le%u017Eitostech
55690,42,1331766000,97,0,31,1,129,A,Doh.mezi%20%u010CR%20a%20vl.%20Guernsey%20o%20v%FDm.inf.v%20da%u0148.z%E1le%u017Eitostech
55691,43,1331766000,102,1,25,1,129,A,Sml.%20mezi%20%u010CR%20a%20Polskou%20rep.%20o%20zamezen%ED%20dvoj%EDmu%20zdan%u011Bn%ED
55692,44,1331766000,104,0,26,1,131,A,Prot.%20mezi%20%u010CR%20a%20Chorvat.%20rep.%20o%20zamezen%ED%20dvoj.%20zdan%u011Bn%ED
55693,46,1331766000,101,0,29,0,130,A,Zm%u011Bna%20p%u0159%EDlohy%20A%20Stockholmsk%E9%20%FAml.o%20perzist.organ.polutantech
55694,48,1331766000,98,0,31,1,130,A,Doh.mezi%20%u010CR%20a%20Agenturou%20pro%20evrop.glob.nav.sat.syst%E9m
55695,48,1331766000,107,0,28,0,135,A,Doh.mezi%20%u010CR%20a%20Agenturou%20pro%20evrop.glob.nav.sat.syst%E9m
55696,30,1331766000,63,40,13,3,119,A,Novela%20z.%20-%20trestn%ED%20z%E1kon%EDk
55697,32,1331766000,104,0,19,0,123,A,Novela%20z.%20-%20insolven%u010Dn%ED%20z%E1kon
55698,36,1331766000,112,0,19,0,131,A,Novela%20z.%20o%20ochran%u011B%20hospod%E1%u0159sk%E9%20sout%u011B%u017Ee
55699,65,1331766000,62,38,15,20,135,R,N%E1vrh%20na%20z%u0159%EDzen%ED%20vy%u0161et%u0159ovac%ED%20komise%20k%20Budvar%2C%20n.%20p.
55700,66,1331766000,115,0,19,0,134,A,Zpr%E1va%20o%20%u010Dinnosti%20SKVZ%202010-2011
55701,67,1331766000,96,9,23,7,135,A,Zpr%E1va%20o%20%u010Dinnosti%20SKKPO%202010-2011
55702,68,1331766000,111,0,23,0,134,A,Zpr%E1va%20o%20petic%EDch%20za%20obdob%ED%20od%201.%207.%202011%20do%2031.%2012.%202011
55703,64,1331852400,72,62,5,1,140,A,N%E1vrh%20rozpo%u010Dtu%20Pozemkov%E9ho%20fondu%20%u010CR%20na%20rok%202012
55704,0,1332198000,108,24,8,7,147,A,Po%u0159ad%20sch%u016Fze
55705,0,1332198000,92,26,23,19,160,A,Po%u0159ad%20sch%u016Fze
55706,0,1332198000,113,28,6,16,163,A,Po%u0159ad%20sch%u016Fze
55707,0,1332198000,92,50,12,14,168,A,Po%u0159ad%20sch%u016Fze
55708,0,1332198000,93,65,6,4,168,A,Po%u0159ad%20sch%u016Fze
55709,0,1332198000,122,14,27,6,169,A,Po%u0159ad%20sch%u016Fze
55710,38,1332198000,77,77,19,6,179,R,Novela%20z.%20o%20jednac%EDm%20%u0159%E1du%20Poslaneck%E9%20sn%u011Bmovny
55711,38,1332198000,150,5,22,2,179,A,Novela%20z.%20o%20jednac%EDm%20%u0159%E1du%20Poslaneck%E9%20sn%u011Bmovny
55712,39,1332198000,138,2,38,0,178,A,Novela%20z.%20o%20jednac%EDm%20%u0159%E1du%20Sen%E1tu
55713,40,1332198000,103,0,72,2,177,A,Novela%20z.%20-%20trestn%ED%20z%E1kon%EDk
55714,40,1332198000,83,45,20,6,154,A,Novela%20z.%20-%20trestn%ED%20z%E1kon%EDk
55715,40,1332198000,128,3,26,3,160,A,Novela%20z.%20-%20trestn%ED%20z%E1kon%EDk
55716,40,1332198000,85,52,24,4,165,A,Novela%20z.%20-%20trestn%ED%20z%E1kon%EDk
55717,25,1332198000,156,1,10,0,167,A,Novela%20z.%20o%20st%E1tn%ED%20soci%E1ln%ED%20podpo%u0159e
55718,31,1332198000,125,7,36,3,171,A,Novela%20z.%20-%20tiskov%FD%20z%E1kon
55719,35,1332198000,145,1,27,0,173,A,Vl.n.z.%20o%20audiovizi
55720,0,1332198000,123,0,10,0,133,A,%20
55721,1,1332198000,89,28,30,11,158,A,N%E1vrh%20na%20vysloven%ED%20ned%u016Fv%u011Bry%20vl%E1d%u011B%20%u010Cesk%E9%20republiky
55722,1,1332198000,0,0,189,0,189,R,N%E1vrh%20na%20vysloven%ED%20ned%u016Fv%u011Bry%20vl%E1d%u011B%20%u010Cesk%E9%20republiky
55723,0,1332284400,78,12,26,7,123,A,Po%u0159ad%20sch%u016Fze
55724,0,1332284400,85,12,32,12,141,A,Po%u0159ad%20sch%u016Fze
55725,0,1332284400,144,3,6,0,153,A,Po%u0159ad%20sch%u016Fze
55726,49,1332284400,89,75,8,6,178,R,Novela%20z.%20o%20p%u0159estupc%EDch
55727,49,1332284400,146,3,19,4,172,A,Novela%20z.%20o%20p%u0159estupc%EDch
55728,49,1332284400,90,76,2,7,175,A,Novela%20z.%20o%20p%u0159estupc%EDch
55729,49,1332284400,94,74,2,7,177,A,Novela%20z.%20o%20p%u0159estupc%EDch
55730,49,1332284400,129,24,13,12,178,A,Novela%20z.%20o%20p%u0159estupc%EDch
55731,49,1332284400,94,77,2,6,179,A,Novela%20z.%20o%20p%u0159estupc%EDch
55732,74,1332284400,150,5,17,11,183,A,Novela%20z.%20-%20%u017Eivnostensk%FD%20z%E1kon
55733,74,1332284400,174,0,9,0,183,A,Novela%20z.%20-%20%u017Eivnostensk%FD%20z%E1kon
55734,74,1332284400,168,1,9,6,184,A,Novela%20z.%20-%20%u017Eivnostensk%FD%20z%E1kon
55735,52,1332284400,79,71,28,6,184,R,Novela%20z.%20o%20po%u0161tovn%EDch%20slu%u017Eb%E1ch%20-%20EU
55736,52,1332284400,93,50,17,12,172,A,Novela%20z.%20o%20po%u0161tovn%EDch%20slu%u017Eb%E1ch%20-%20EU
55737,52,1332284400,168,5,2,1,176,A,Novela%20z.%20o%20po%u0161tovn%EDch%20slu%u017Eb%E1ch%20-%20EU
55738,52,1332284400,103,76,0,1,180,A,Novela%20z.%20o%20po%u0161tovn%EDch%20slu%u017Eb%E1ch%20-%20EU
55739,52,1332284400,78,99,3,0,180,R,Novela%20z.%20o%20po%u0161tovn%EDch%20slu%u017Eb%E1ch%20-%20EU
55740,52,1332284400,100,67,10,2,179,A,Novela%20z.%20o%20po%u0161tovn%EDch%20slu%u017Eb%E1ch%20-%20EU
55741,52,1332284400,111,37,31,1,180,A,Novela%20z.%20o%20po%u0161tovn%EDch%20slu%u017Eb%E1ch%20-%20EU
55742,52,1332284400,85,85,8,2,180,R,Novela%20z.%20o%20po%u0161tovn%EDch%20slu%u017Eb%E1ch%20-%20EU
55743,52,1332284400,174,0,6,1,181,A,Novela%20z.%20o%20po%u0161tovn%EDch%20slu%u017Eb%E1ch%20-%20EU
55744,52,1332284400,86,85,6,3,180,R,Novela%20z.%20o%20po%u0161tovn%EDch%20slu%u017Eb%E1ch%20-%20EU
55745,52,1332284400,75,94,9,3,181,R,Novela%20z.%20o%20po%u0161tovn%EDch%20slu%u017Eb%E1ch%20-%20EU
55746,52,1332284400,76,98,7,0,181,R,Novela%20z.%20o%20po%u0161tovn%EDch%20slu%u017Eb%E1ch%20-%20EU
55747,52,1332284400,78,102,1,0,181,R,Novela%20z.%20o%20po%u0161tovn%EDch%20slu%u017Eb%E1ch%20-%20EU
55748,52,1332284400,5,170,3,3,181,R,Novela%20z.%20o%20po%u0161tovn%EDch%20slu%u017Eb%E1ch%20-%20EU
55749,52,1332284400,105,73,1,4,183,A,Novela%20z.%20o%20po%u0161tovn%EDch%20slu%u017Eb%E1ch%20-%20EU
55750,59,1332284400,152,2,27,1,182,A,Novela%20z.%20o%20investi%u010Dn%EDch%20pob%EDdk%E1ch
55751,59,1332284400,104,19,48,11,182,A,Novela%20z.%20o%20investi%u010Dn%EDch%20pob%EDdk%E1ch
55752,59,1332284400,79,79,20,4,182,R,Novela%20z.%20o%20investi%u010Dn%EDch%20pob%EDdk%E1ch
55753,59,1332284400,57,101,17,7,182,R,Novela%20z.%20o%20investi%u010Dn%EDch%20pob%EDdk%E1ch
55754,59,1332284400,92,23,41,27,183,A,Novela%20z.%20o%20investi%u010Dn%EDch%20pob%EDdk%E1ch
55755,51,1332284400,127,14,11,10,162,A,Novela%20z.%20o%20dluhopisech%20-%20EU
55756,51,1332284400,144,12,6,5,167,A,Novela%20z.%20o%20dluhopisech%20-%20EU
55757,58,1332284400,153,4,14,0,171,A,Novela%20z.%20o%20rozpo%u010Dtov%FDch%20pravidlech
55758,58,1332284400,159,2,11,0,172,A,Novela%20z.%20o%20rozpo%u010Dtov%FDch%20pravidlech
55759,58,1332284400,35,91,18,28,172,R,Novela%20z.%20o%20rozpo%u010Dtov%FDch%20pravidlech
55760,58,1332284400,161,4,7,0,172,A,Novela%20z.%20o%20rozpo%u010Dtov%FDch%20pravidlech
55761,58,1332284400,165,4,5,0,174,A,Novela%20z.%20o%20rozpo%u010Dtov%FDch%20pravidlech
55762,61,1332284400,162,1,10,2,175,A,Novela%20z.%20o%20bank%E1ch
55763,55,1332284400,160,1,13,0,174,A,Novela%20z.%20o%20p%u0159echodu%20v%u011Bc%ED%20z%20majetku%20%u010CR%20do%20vlastnictv%ED%20obc%ED
55764,55,1332284400,165,0,10,0,175,A,Novela%20z.%20o%20p%u0159echodu%20v%u011Bc%ED%20z%20majetku%20%u010CR%20do%20vlastnictv%ED%20obc%ED
55765,56,1332284400,97,59,4,6,166,A,Novela%20z.%20-%20trestn%ED%20%u0159%E1d
55766,56,1332284400,100,68,1,2,171,A,Novela%20z.%20-%20trestn%ED%20%u0159%E1d
55767,57,1332284400,163,1,10,0,174,A,Novela%20z.%20-%20ob%u010Dansk%FD%20z%E1kon%EDk
55768,57,1332284400,166,0,10,0,176,A,Novela%20z.%20-%20ob%u010Dansk%FD%20z%E1kon%EDk
55769,0,1332284400,149,0,25,2,176,A,%20
55770,0,1332284400,158,0,17,1,176,A,%20
55771,62,1332284400,64,2,106,2,174,R,Novela%20z.%20o%20da%u0148ov%E9m%20poradenstv%ED
55772,62,1332284400,133,0,36,5,174,A,Novela%20z.%20o%20da%u0148ov%E9m%20poradenstv%ED
55773,62,1332284400,133,3,35,3,174,A,Novela%20z.%20o%20da%u0148ov%E9m%20poradenstv%ED
55774,71,1332284400,159,1,14,0,174,A,N%E1vrh%20na%20zm%u011Bny%20ve%20slo%u017Een%ED%20org%E1n%u016F%20Poslaneck%E9%20sn%u011Bmovny
55775,71,1332284400,152,0,22,0,174,A,N%E1vrh%20na%20zm%u011Bny%20ve%20slo%u017Een%ED%20org%E1n%u016F%20Poslaneck%E9%20sn%u011Bmovny
55776,73,1332284400,147,0,27,1,175,A,N%E1vrh%20na%20volbu%20%u010Dlen%u016F%20R%20SF%20%u010CR%20pro%20podporu%20a%20rozvoj%20%u010Desk%E9%20kinematografie
55777,50,1332284400,125,1,39,0,165,A,Vl.n.z.%20o%20evropsk%E9%20ob%u010Dansk%E9%20iniciativ%u011B%20-%20EU
55778,50,1332284400,129,2,35,1,167,A,Vl.n.z.%20o%20evropsk%E9%20ob%u010Dansk%E9%20iniciativ%u011B%20-%20EU
55779,60,1332284400,132,0,33,1,166,A,Novela%20z.%20o%20archivnictv%ED%20a%20spisov%E9%20slu%u017Eb%u011B
55780,60,1332284400,139,2,28,1,170,A,Novela%20z.%20o%20archivnictv%ED%20a%20spisov%E9%20slu%u017Eb%u011B
55781,60,1332284400,140,2,27,0,169,A,Novela%20z.%20o%20archivnictv%ED%20a%20spisov%E9%20slu%u017Eb%u011B
55782,60,1332284400,5,102,56,5,168,R,Novela%20z.%20o%20archivnictv%ED%20a%20spisov%E9%20slu%u017Eb%u011B
55783,60,1332284400,43,70,51,4,168,R,Novela%20z.%20o%20archivnictv%ED%20a%20spisov%E9%20slu%u017Eb%u011B
55784,60,1332284400,142,1,26,0,169,A,Novela%20z.%20o%20archivnictv%ED%20a%20spisov%E9%20slu%u017Eb%u011B
55785,60,1332284400,137,3,28,1,169,A,Novela%20z.%20o%20archivnictv%ED%20a%20spisov%E9%20slu%u017Eb%u011B
55786,0,1332284400,111,14,40,0,165,A,%20
55787,0,1335218400,183,2,4,0,189,A,%20
55788,0,1335218400,103,81,3,2,189,A,%20
55789,0,1335218400,183,2,3,1,189,A,%20
55790,0,1335218400,100,87,2,0,189,A,%20
55791,0,1335477600,171,0,12,0,183,A,Po%u0159ad%20sch%u016Fze
55792,0,1335477600,138,14,28,8,188,A,Po%u0159ad%20sch%u016Fze
55793,1,1335477600,105,93,0,0,198,A,%u017D%E1dost%20vl%E1dy%20%u010Cesk%E9%20republiky%20o%20vysloven%ED%20d%u016Fv%u011Bry
55794,0,1335909600,86,96,8,1,191,R,Po%u0159ad%20sch%u016Fze
55795,0,1335909600,86,72,17,16,191,R,Po%u0159ad%20sch%u016Fze
55796,0,1335909600,88,97,4,2,191,R,Po%u0159ad%20sch%u016Fze
55797,0,1335909600,89,97,1,2,189,R,Po%u0159ad%20sch%u016Fze
55798,0,1335909600,80,103,4,3,190,R,Po%u0159ad%20sch%u016Fze
55799,0,1335909600,112,27,28,22,189,A,Po%u0159ad%20sch%u016Fze
55800,0,1335909600,112,21,32,25,190,A,Po%u0159ad%20sch%u016Fze
55801,0,1335909600,148,14,22,6,190,A,Po%u0159ad%20sch%u016Fze
55802,0,1335909600,112,46,24,8,190,A,Po%u0159ad%20sch%u016Fze
55803,0,1335909600,183,2,5,0,190,A,Po%u0159ad%20sch%u016Fze
55804,0,1335909600,184,2,4,0,190,A,Po%u0159ad%20sch%u016Fze
55805,0,1335909600,179,5,2,4,190,A,Po%u0159ad%20sch%u016Fze
55806,0,1335909600,182,0,5,3,190,A,Po%u0159ad%20sch%u016Fze
55807,0,1335909600,114,46,22,8,190,A,Po%u0159ad%20sch%u016Fze
55808,0,1335909600,112,17,34,27,190,A,Po%u0159ad%20sch%u016Fze
55809,0,1335909600,115,16,29,30,190,A,Po%u0159ad%20sch%u016Fze
55810,0,1335909600,112,22,28,28,190,A,Po%u0159ad%20sch%u016Fze
55811,0,1335909600,147,40,1,3,191,A,Po%u0159ad%20sch%u016Fze
55812,0,1335909600,110,47,24,10,191,A,Po%u0159ad%20sch%u016Fze
55813,0,1335909600,173,2,14,1,190,A,Po%u0159ad%20sch%u016Fze
55814,2,1335909600,108,68,6,1,183,A,Novela%20z.%20o%20m%EDstn%EDch%20poplatc%EDch
55815,3,1335909600,176,0,0,0,176,A,Vl.n.z.%20o%20mediaci%20-%20EU
55816,4,1335909600,138,14,21,4,177,A,Vl.n.z.%20o%20ochran%u011B%20ovzdu%u0161%ED%20-%20EU
55817,6,1335909600,76,67,6,18,167,R,Novela%20z.%20o%20rostlinol%E9ka%u0159sk%E9%20p%E9%u010Di%20-%20EU
55818,6,1335909600,159,5,5,3,172,A,Novela%20z.%20o%20rostlinol%E9ka%u0159sk%E9%20p%E9%u010Di%20-%20EU
55819,7,1335909600,156,0,16,1,173,A,Novela%20z.%20o%20pedagogick%FDch%20pracovn%EDc%EDch
55820,73,1335909600,142,4,24,3,173,A,N%E1vrh%20na%20zkr%E1cen%ED%20lh%u016Fty%20k%20projedn%E1n%ED%20tisku%20623
55821,19,1335909600,135,0,3,0,138,A,Novela%20z.%20o%20provozov%E1n%ED%20rozhlasov%E9ho%20a%20tel.%20vys%EDl%E1n%ED
55822,0,1335996000,100,1,3,0,104,A,Po%u0159ad%20sch%u016Fze
55823,0,1335996000,105,0,1,0,106,A,Po%u0159ad%20sch%u016Fze
55824,0,1335996000,104,1,3,0,108,A,Po%u0159ad%20sch%u016Fze
55825,85,1335996000,41,56,34,3,134,R,P%EDsemn%E1%20interpelace%20V.%20Filipa%20na%20J.%20Dr%E1bka%20ve%20v%u011Bci%20transformace%20soci%E1l
55826,47,1335996000,119,0,26,0,145,A,Doh.%20mezi%20%u010CR%20a%20vl.%20Rep.%20Uzbekist%E1n%20o%20leteck%FDch%20slu%u017Eb%E1ch
55827,55,1335996000,116,0,29,0,145,A,Doh.mezi%20vl%E1dou%20%u010CR%20a%20vl%E1dou%20St%E1tu%20Katar%20o%20leteck%E9%20doprav%u011B
55828,56,1335996000,123,1,23,0,147,A,%DAml.o%20potla%u010D.%20protipr%E1vn%EDch%20%u010Din%u016F%20souvis.%20s%20mezin%E1r.letectv%EDm
55829,60,1335996000,127,0,20,0,147,A,Prot.%20a%20doh.mezi%20%u010CR%20a%20vl.Vietnam.soc.rep.%20o%20let.slu%u017Eb%E1ch
55830,87,1335996000,126,0,22,1,149,A,Doh.mezi%20%u010CR%20a%20Agenturou%20pro%20evrop.glob.nav.sat.syst%E9m
55831,46,1335996000,135,0,16,0,151,A,Sml.%20mezi%20%u010CR%20a%20vl.%20Barbadosu%20o%20zamezen%ED%20dvoj%EDmu%20zdan%u011Bn%ED
55832,48,1335996000,130,1,19,0,150,A,Sml.mezi%20%u010CR%20a%20Estonskou%20rep.o%20ochran%u011B%20utaj.%20informac%ED
55833,50,1335996000,130,0,20,0,150,A,Sml.%20mezi%20%u010CR%20a%20Moldavskou%20rep.%20o%20soci%E1ln%EDm%20zabezpe%u010Den%ED
55834,51,1335996000,121,0,26,0,147,A,Prot.%20mezi%20%u010CR%20a%20vl.%20Uzbeck%E9%20rep.%20o%20zamezen%ED%20dvoj%EDho%20zdan%u011Bn%ED
55835,53,1335996000,119,1,26,0,146,A,Sml.mezi%20%u010CR%20a%20Ruskou%20federac%ED%20o%20soci%E1ln%EDm%20zabezpe%u010Den%ED
55836,54,1335996000,120,0,25,0,145,A,Doh.%20mezi%20%u010CR%20a%20Rep.%20San%20Marino%20o%20v%FDm%u011Bn%u011B%20inf.%20v%20da%u0148.%20z%E1le%u017Eit.
55837,57,1335996000,117,0,27,0,144,A,Zm%u011Bny%20p%u0159%EDlohy%20III%20Rotterdamsk%E9%20%FAmluvy
55838,58,1335996000,119,0,26,0,145,A,Doh.%20o%20zalo%u017Een%ED%20Evropsk%E9%20banky%20pro%20obnovu%20a%20rozvoj
55839,59,1335996000,117,0,28,0,145,A,Zm%u011Bna%20P%u0159%EDlohy%20I%20Mezin%E1rodn%ED%20%FAmluvy%20proti%20dopingu%20ve%20sportu
55840,74,1335996000,97,17,29,2,145,A,Dlouhodob%FD%20z%E1m%u011Br%20vzd%u011Bl%E1v%E1n%ED%20a%20rozvoje%20vzd%u011Bl%E1vac%ED%20soustavy%20%u010CR
55841,75,1335996000,12,1,131,0,144,R,Zpr%E1va%20o%20%u017Eivotn%EDm%20prost%u0159ed%ED%20%u010CR%20v%20roce%202010
55842,75,1335996000,93,6,14,6,119,A,Zpr%E1va%20o%20%u017Eivotn%EDm%20prost%u0159ed%ED%20%u010CR%20v%20roce%202010
55843,78,1335996000,73,5,31,25,134,A,N%E1vrhy%20zdravotn%u011B%20pojistn%FDch%20pl%E1n%u016F%20na%20rok%202012
55844,79,1335996000,123,0,13,0,136,A,V%FDro%u010Dn%ED%20zpr%E1va%20o%20%u010Dinnosti%20Kontroln%ED%20rady%20TA%u010CR
55845,81,1335996000,119,1,15,0,135,A,Zpr%E1va%20o%20%u010Dinnosti%20St%E1l%E9%20komise%20Poslaneck%E9%20sn%u011Bmovny%20Parlamentu%20%u010CR%20pro%20k
55846,82,1335996000,116,0,16,0,132,A,N%E1vrh%20%u010Dasov%E9ho%20harmonogramu%20projedn%E1v%E1n%ED%20st%E1tn%EDho%20z%E1v%u011Bre%u010Dn%E9ho%20%FA%u010Dtu%20%u010Ces
55847,83,1335996000,113,0,17,0,130,A,Zpr%E1va%20o%20kontrole%20v%FDro%u010Dn%EDch%20finan%u010Dn%EDch%20zpr%E1v%202011
55848,84,1335996000,112,0,18,0,130,A,Dopln%u011Bn%ED%20v%FDro%u010Dn%EDch%20finan%u010Dn%EDch%20zpr%E1v%202007%20a%u017E%202010
55849,0,1336082400,97,15,30,17,159,A,Po%u0159ad%20sch%u016Fze
55850,0,1336082400,91,65,1,2,159,A,Po%u0159ad%20sch%u016Fze
55851,0,1336082400,90,50,17,5,162,A,Po%u0159ad%20sch%u016Fze
55852,76,1336082400,122,9,25,14,170,A,Zpr%E1va%20o%20inflaci%20-%20leden%202012
55853,41,1336082400,141,0,31,0,172,A,Novela%20z.%20o%20rozpo%u010Dtov%FDch%20pravidlech
55854,5,1336082400,119,13,18,10,160,A,Novela%20z.%20o%20provozu%20na%20pozemn%EDch%20komunikac%EDch
55855,8,1336082400,88,35,14,16,153,A,Novela%20z.%20o%20pozemn%EDch%20komunikac%EDch%20-%20EU
55856,61,1336082400,151,0,6,1,158,A,Vl.%20n.%20z.%2C%20kter%FDm%20se%20m%u011Bn%ED%20volebn%ED%20z%E1kony%20-%20EU
55857,61,1336082400,56,69,15,18,158,R,Vl.%20n.%20z.%2C%20kter%FDm%20se%20m%u011Bn%ED%20volebn%ED%20z%E1kony%20-%20EU
55858,61,1336082400,63,56,25,15,159,R,Vl.%20n.%20z.%2C%20kter%FDm%20se%20m%u011Bn%ED%20volebn%ED%20z%E1kony%20-%20EU
55859,61,1336082400,94,9,26,30,159,A,Vl.%20n.%20z.%2C%20kter%FDm%20se%20m%u011Bn%ED%20volebn%ED%20z%E1kony%20-%20EU
55860,77,1335996000,112,0,9,1,122,A,Zpr%E1va%20o%20stavu%20vys%EDl%E1n%ED%20a%20%u010Dinnosti%20Rady%20RTV%20za%20rok%202011
55861,49,1336082400,129,0,28,0,157,A,Sml.mezi%20%u010CR%20a%20Rak.rep.o%20zm%u011Bn%E1ch%20pr%u016Fb%u011Bhu%20spol.st%E1tn%EDch%20hranic
55862,52,1336082400,135,1,22,0,158,A,Sml.mezi%20%u010CR%20a%20vl.Rusk%E9%20fed.%20o%20spolupr.v%20boji%20proti%20trest.%u010D.
55863,0,1336082400,72,77,1,1,151,R,%20
55864,0,1336082400,77,84,0,0,161,R,%20
55865,40,1336082400,66,80,0,0,146,R,Novela%20z.%20o%20d%u016Fchodov%E9m%20poji%u0161t%u011Bn%ED
55866,40,1336082400,72,80,0,0,152,R,Novela%20z.%20o%20d%u016Fchodov%E9m%20poji%u0161t%u011Bn%ED
55867,40,1336082400,79,85,0,0,164,R,Novela%20z.%20o%20d%u016Fchodov%E9m%20poji%u0161t%u011Bn%ED
55868,40,1336082400,158,3,1,2,164,A,Novela%20z.%20o%20d%u016Fchodov%E9m%20poji%u0161t%u011Bn%ED
55869,40,1336082400,85,79,0,0,164,A,Novela%20z.%20o%20d%u016Fchodov%E9m%20poji%u0161t%u011Bn%ED
55870,0,1336082400,85,52,15,8,160,A,%20
55871,0,1336514400,152,2,2,0,156,A,Po%u0159ad%20sch%u016Fze
55872,0,1336514400,104,12,26,22,164,A,Po%u0159ad%20sch%u016Fze
55873,1,1336514400,145,8,10,11,174,A,Vl.n.z.%20o%20podporovan%FDch%20zdroj%EDch%20energie%20-%20EU
55874,21,1336514400,163,0,14,1,178,A,Novela%20z.%20o%20ochran%u011B%20spot%u0159ebitele%20-%20EU
55875,21,1336514400,153,0,20,4,177,A,Novela%20z.%20o%20ochran%u011B%20spot%u0159ebitele%20-%20EU
55876,45,1336514400,151,1,25,0,177,A,Rozhodnut%ED%20Evropsk%E9%20rady%20-%20zm%u011Bna%20%u010Dl.%20136%20Sml.%20o%20fungov%E1n%ED%20EU
55877,45,1336514400,145,7,17,2,171,A,Rozhodnut%ED%20Evropsk%E9%20rady%20-%20zm%u011Bna%20%u010Dl.%20136%20Sml.%20o%20fungov%E1n%ED%20EU
55878,66,1336514400,71,47,39,10,167,R,Novela%20z.%20o%20odpov%u011Bdnosti%20za%20%u0161kodu%20zp%u016Fs.p%u0159i%20v%FDkonu%20ve%u0159ej.moci
55879,66,1336514400,74,55,26,10,165,R,Novela%20z.%20o%20odpov%u011Bdnosti%20za%20%u0161kodu%20zp%u016Fs.p%u0159i%20v%FDkonu%20ve%u0159ej.moci
55880,66,1336514400,154,1,6,7,168,A,Novela%20z.%20o%20odpov%u011Bdnosti%20za%20%u0161kodu%20zp%u016Fs.p%u0159i%20v%FDkonu%20ve%u0159ej.moci
55881,66,1336514400,56,70,27,14,167,R,Novela%20z.%20o%20odpov%u011Bdnosti%20za%20%u0161kodu%20zp%u016Fs.p%u0159i%20v%FDkonu%20ve%u0159ej.moci
55882,33,1336514400,48,95,5,3,151,R,Novela%20z.%20o%20podpo%u0159e%20v%FDzkumu%20a%20v%FDvoje
55883,33,1336514400,146,2,6,1,155,A,Novela%20z.%20o%20podpo%u0159e%20v%FDzkumu%20a%20v%FDvoje
55884,38,1336514400,137,0,23,0,160,A,Novela%20z.%20o%20St%E1tn%EDm%20fondu%20rozvoje%20bydlen%ED
55885,38,1336514400,131,1,25,5,162,A,Novela%20z.%20o%20St%E1tn%EDm%20fondu%20rozvoje%20bydlen%ED
55886,39,1336514400,133,0,30,0,163,A,Vl.n.z.%2Ckter%FDm%20se%20upravuj%ED%20ot%E1zky%20souvis.%20s%20u%u017E%EDv%E1n%EDm%20byt%u016F
55887,62,1336514400,46,99,2,7,154,R,Novela%20z.%20o%20%FA%u010Detnictv%ED%20-%20EU
55888,62,1336514400,121,6,24,9,160,A,Novela%20z.%20o%20%FA%u010Detnictv%ED%20-%20EU
55889,63,1336514400,157,0,3,0,160,A,Novela%20z.o%20%FAprav%u011B%20n%u011Bkter%FDch%20vztah%u016F%20v%20oblasti%20ve%u0159ejn%E9%20podpory%20-%20EU
55890,63,1336514400,157,0,3,0,160,A,Novela%20z.o%20%FAprav%u011B%20n%u011Bkter%FDch%20vztah%u016F%20v%20oblasti%20ve%u0159ejn%E9%20podpory%20-%20EU
55891,63,1336514400,157,1,2,0,160,A,Novela%20z.o%20%FAprav%u011B%20n%u011Bkter%FDch%20vztah%u016F%20v%20oblasti%20ve%u0159ejn%E9%20podpory%20-%20EU
55892,64,1336514400,145,3,12,0,160,A,Novela%20z.%20na%20ochranu%20zv%ED%u0159at%20proti%20t%FDr%E1n%ED%20-%20EU
55893,64,1336514400,153,0,9,0,162,A,Novela%20z.%20na%20ochranu%20zv%ED%u0159at%20proti%20t%FDr%E1n%ED%20-%20EU
55894,64,1336514400,156,0,5,1,162,A,Novela%20z.%20na%20ochranu%20zv%ED%u0159at%20proti%20t%FDr%E1n%ED%20-%20EU
55895,64,1336514400,12,89,35,27,163,R,Novela%20z.%20na%20ochranu%20zv%ED%u0159at%20proti%20t%FDr%E1n%ED%20-%20EU
55896,64,1336514400,140,8,7,8,163,A,Novela%20z.%20na%20ochranu%20zv%ED%u0159at%20proti%20t%FDr%E1n%ED%20-%20EU
55897,64,1336514400,14,89,31,29,163,R,Novela%20z.%20na%20ochranu%20zv%ED%u0159at%20proti%20t%FDr%E1n%ED%20-%20EU
55898,64,1336514400,20,83,39,22,164,R,Novela%20z.%20na%20ochranu%20zv%ED%u0159at%20proti%20t%FDr%E1n%ED%20-%20EU
55899,64,1336514400,17,84,36,27,164,R,Novela%20z.%20na%20ochranu%20zv%ED%u0159at%20proti%20t%FDr%E1n%ED%20-%20EU
55900,64,1336514400,20,87,34,23,164,R,Novela%20z.%20na%20ochranu%20zv%ED%u0159at%20proti%20t%FDr%E1n%ED%20-%20EU
55901,64,1336514400,154,0,10,1,165,A,Novela%20z.%20na%20ochranu%20zv%ED%u0159at%20proti%20t%FDr%E1n%ED%20-%20EU
55902,65,1336514400,148,0,18,0,166,A,Novela%20z.%20o%20bank%E1ch
55903,65,1336514400,83,34,35,16,168,R,Novela%20z.%20o%20bank%E1ch
55904,65,1336514400,138,4,20,6,168,A,Novela%20z.%20o%20bank%E1ch
55905,65,1336514400,85,32,21,16,154,A,Novela%20z.%20o%20bank%E1ch
55906,65,1336514400,146,3,2,3,154,A,Novela%20z.%20o%20bank%E1ch
55907,65,1336514400,145,2,2,6,155,A,Novela%20z.%20o%20bank%E1ch
55908,67,1336514400,132,1,22,5,160,A,Vl.n.%FAstav.z.%20o%20zm%u011Bn%E1ch%20st%E1tn%EDch%20hranic%20s%20Rakouskou%20rep.
55909,68,1336514400,4,96,28,33,161,R,Novela%20z.%20o%20ozbrojen%FDch%20sil%E1ch%20%u010Cesk%E9%20republiky
55910,68,1336514400,135,12,14,3,164,A,Novela%20z.%20o%20ozbrojen%FDch%20sil%E1ch%20%u010Cesk%E9%20republiky
55911,68,1336514400,146,1,16,1,164,A,Novela%20z.%20o%20ozbrojen%FDch%20sil%E1ch%20%u010Cesk%E9%20republiky
55912,68,1336514400,151,0,14,0,165,A,Novela%20z.%20o%20ozbrojen%FDch%20sil%E1ch%20%u010Cesk%E9%20republiky
55913,69,1336514400,137,2,21,5,165,A,Novela%20z.%20o%20zaji%u0161t%u011Bn%ED%20bezpe%u010Dnosti%20a%20ochr.%20zdrav%ED%20p%u0159i%20pr%E1ci
55914,70,1336514400,145,1,19,2,167,A,Vl.n.z.%20o%20kontrole%20%28kontroln%ED%20%u0159%E1d%29
55915,70,1336514400,146,0,20,2,168,A,Vl.n.z.%20o%20kontrole%20%28kontroln%ED%20%u0159%E1d%29
55916,70,1336514400,114,9,17,29,169,A,Vl.n.z.%20o%20kontrole%20%28kontroln%ED%20%u0159%E1d%29
55917,71,1336514400,155,0,13,1,169,A,Novela%20z.%20o%20ryb%E1%u0159stv%ED
55918,0,1336514400,108,12,38,10,168,A,%20
55919,0,1338847200,174,0,13,0,187,A,""
55920,0,1338847200,182,4,3,5,194,A,Po%u0159ad%20sch%u016Fze
55921,0,1338847200,91,85,8,10,194,R,Po%u0159ad%20sch%u016Fze
55922,0,1338847200,113,60,10,12,195,A,Po%u0159ad%20sch%u016Fze
55923,0,1338847200,33,84,43,35,195,R,Po%u0159ad%20sch%u016Fze
55924,0,1338847200,107,67,14,7,195,A,Po%u0159ad%20sch%u016Fze
55925,0,1338847200,103,87,2,3,195,A,Po%u0159ad%20sch%u016Fze
55926,0,1338847200,103,74,8,9,194,A,Po%u0159ad%20sch%u016Fze
55927,0,1338847200,156,4,19,13,192,A,""
55928,1,1338847200,75,76,17,23,191,R,Rozhodnut%ED%20PS%20k%20st%EDh%E1n%ED%20Davida%20Ratha
55929,1,1338847200,183,2,3,3,191,A,Rozhodnut%ED%20PS%20k%20st%EDh%E1n%ED%20Davida%20Ratha
55930,2,1338847200,140,18,23,8,189,A,Rozhodnut%ED%20Evropsk%E9%20rady%20-%20zm%u011Bna%20%u010Dl.%20136%20Sml.%20o%20fungov%E1n%ED%20EU
55931,3,1338847200,105,63,18,6,192,A,Novela%20z.%20o%20p%u0159estupc%EDch
55932,4,1338847200,98,76,1,0,175,R,Novela%20z.%20o%20po%u0161tovn%EDch%20slu%u017Eb%E1ch%20-%20EU
55933,4,1338847200,128,17,22,8,175,A,Novela%20z.%20o%20po%u0161tovn%EDch%20slu%u017Eb%E1ch%20-%20EU
55934,4,1338847200,102,74,2,1,179,A,Novela%20z.%20o%20po%u0161tovn%EDch%20slu%u017Eb%E1ch%20-%20EU
55935,5,1338847200,130,7,33,1,171,A,Novela%20z.%20o%20elektronick%FDch%20komunikac%EDch%20-%20EU
55936,59,1338847200,10,95,26,12,143,R,Novela%20z.%20o%20rozpo%u010Dtov%E9m%20ur%u010Den%ED%20dan%ED
55937,59,1338847200,148,0,1,0,149,A,Novela%20z.%20o%20rozpo%u010Dtov%E9m%20ur%u010Den%ED%20dan%ED
55938,59,1338847200,129,7,10,3,149,A,Novela%20z.%20o%20rozpo%u010Dtov%E9m%20ur%u010Den%ED%20dan%ED
55939,22,1338847200,50,68,0,0,118,R,Novela%20z.%20o%20d%u016Fchodov%E9m%20poji%u0161t%u011Bn%ED
55940,0,1338933600,128,23,12,16,179,A,Po%u0159ad%20sch%u016Fze
55941,0,1338933600,104,24,29,22,179,A,Po%u0159ad%20sch%u016Fze
55942,0,1338933600,94,64,14,7,179,A,Po%u0159ad%20sch%u016Fze
55943,0,1338933600,173,1,4,1,179,A,Po%u0159ad%20sch%u016Fze
55944,0,1338933600,177,0,2,0,179,A,Po%u0159ad%20sch%u016Fze
55945,14,1338933600,54,48,2,2,106,A,Vl.n.z.%20o%20majetkov%E9m%20vyrovn%E1n%ED%20s%20c%EDrkvemi%20a%20n%E1bo%u017Een.%20spole%u010D.
55946,14,1338933600,108,16,7,9,140,A,Vl.n.z.%20o%20majetkov%E9m%20vyrovn%E1n%ED%20s%20c%EDrkvemi%20a%20n%E1bo%u017Een.%20spole%u010D.
55947,14,1338933600,72,75,0,0,147,R,Vl.n.z.%20o%20majetkov%E9m%20vyrovn%E1n%ED%20s%20c%EDrkvemi%20a%20n%E1bo%u017Een.%20spole%u010D.
55948,14,1338933600,122,25,6,3,156,A,Vl.n.z.%20o%20majetkov%E9m%20vyrovn%E1n%ED%20s%20c%EDrkvemi%20a%20n%E1bo%u017Een.%20spole%u010D.
55949,14,1338933600,83,75,0,0,158,A,Vl.n.z.%20o%20majetkov%E9m%20vyrovn%E1n%ED%20s%20c%EDrkvemi%20a%20n%E1bo%u017Een.%20spole%u010D.
55950,14,1338933600,51,49,62,11,173,R,Vl.n.z.%20o%20majetkov%E9m%20vyrovn%E1n%ED%20s%20c%EDrkvemi%20a%20n%E1bo%u017Een.%20spole%u010D.
55951,14,1338933600,79,83,0,1,163,R,Vl.n.z.%20o%20majetkov%E9m%20vyrovn%E1n%ED%20s%20c%EDrkvemi%20a%20n%E1bo%u017Een.%20spole%u010D.
55952,14,1338933600,77,84,2,0,163,R,Vl.n.z.%20o%20majetkov%E9m%20vyrovn%E1n%ED%20s%20c%EDrkvemi%20a%20n%E1bo%u017Een.%20spole%u010D.
55953,14,1338933600,74,81,7,0,162,R,Vl.n.z.%20o%20majetkov%E9m%20vyrovn%E1n%ED%20s%20c%EDrkvemi%20a%20n%E1bo%u017Een.%20spole%u010D.
55954,32,1338933600,56,70,14,0,140,R,Vl.n.z.o%20zm%u011Bn%u011B%20da%u0148ov%FDch%2C%20pojistn%FDch%20a%20dal%u0161%EDch%20z%E1kon%u016F%20-%20EU
55955,32,1338933600,51,73,1,2,127,R,Vl.n.z.o%20zm%u011Bn%u011B%20da%u0148ov%FDch%2C%20pojistn%FDch%20a%20dal%u0161%EDch%20z%E1kon%u016F%20-%20EU
55956,32,1338933600,125,1,1,0,127,A,Vl.n.z.o%20zm%u011Bn%u011B%20da%u0148ov%FDch%2C%20pojistn%FDch%20a%20dal%u0161%EDch%20z%E1kon%u016F%20-%20EU
55957,32,1338933600,56,58,8,5,127,R,Vl.n.z.o%20zm%u011Bn%u011B%20da%u0148ov%FDch%2C%20pojistn%FDch%20a%20dal%u0161%EDch%20z%E1kon%u016F%20-%20EU
55958,32,1338933600,54,68,3,2,127,R,Vl.n.z.o%20zm%u011Bn%u011B%20da%u0148ov%FDch%2C%20pojistn%FDch%20a%20dal%u0161%EDch%20z%E1kon%u016F%20-%20EU
55959,32,1338933600,71,55,1,0,127,A,Vl.n.z.o%20zm%u011Bn%u011B%20da%u0148ov%FDch%2C%20pojistn%FDch%20a%20dal%u0161%EDch%20z%E1kon%u016F%20-%20EU
55960,0,1339020000,69,0,19,2,90,A,Po%u0159ad%20sch%u016Fze
55961,0,1339020000,59,15,19,2,95,A,Po%u0159ad%20sch%u016Fze
55962,0,1339020000,60,30,5,2,97,A,Po%u0159ad%20sch%u016Fze
55963,114,1339020000,47,23,5,8,83,A,P%EDsemn%E1%20interpelace%20B.%20Petra%20na%20M.%20Kubu%20ve%20v%u011Bci%20zpracov%E1n%ED%20st%E1tn%ED%20ener
55964,102,1339020000,122,1,9,2,134,A,Souhr.%20zpr%E1va%20o%20%u010Dinnosti%20ve%u0159ejn%E9ho%20ochr%E1nce%20pr%E1v%20za%20rok%202011
55965,56,1339020000,111,0,33,0,144,A,Novela%20z.%20o%20vyvlastn%u011Bn%ED
55966,56,1339020000,52,46,35,11,144,R,Novela%20z.%20o%20vyvlastn%u011Bn%ED
55967,56,1339020000,60,38,37,9,144,R,Novela%20z.%20o%20vyvlastn%u011Bn%ED
55968,0,1339106400,89,25,28,16,158,A,Po%u0159ad%20sch%u016Fze
55969,0,1339106400,90,25,30,14,159,A,Po%u0159ad%20sch%u016Fze
55970,0,1339106400,105,15,27,12,159,A,Po%u0159ad%20sch%u016Fze
55971,0,1339106400,70,69,13,8,160,R,Po%u0159ad%20sch%u016Fze
55972,0,1339106400,107,14,24,12,157,A,Po%u0159ad%20sch%u016Fze
55973,0,1339106400,78,61,17,5,161,R,Po%u0159ad%20sch%u016Fze
55974,0,1339106400,73,56,28,5,162,R,Po%u0159ad%20sch%u016Fze
55975,0,1339106400,73,29,39,21,162,R,Po%u0159ad%20sch%u016Fze
55976,66,1339106400,151,0,12,1,164,A,Sml.%20o%20p%u0159istoupen%ED%20Chorvatsk%E9%20republiky%20k%20Evropsk%E9%20unii
55977,12,1339106400,63,85,4,2,154,R,Novela%20z.%20o%20soci%E1ln%u011B-pr%E1vn%ED%20ochran%u011B%20d%u011Bt%ED
55978,12,1339106400,122,3,26,6,157,A,Novela%20z.%20o%20soci%E1ln%u011B-pr%E1vn%ED%20ochran%u011B%20d%u011Bt%ED
55979,13,1339106400,110,26,15,5,156,A,Novela%20z.%20o%20v%FDkonu%20%FAstavn%ED%20v%FDchovy
55980,33,1339106400,141,0,15,0,156,A,Novela%20z.%20o%20l%E9%u010Divech
55981,33,1339106400,102,26,22,5,155,A,Novela%20z.%20o%20l%E9%u010Divech
55982,0,1339452000,126,10,23,7,166,A,Po%u0159ad%20sch%u016Fze
55983,0,1339452000,164,5,3,4,176,A,Po%u0159ad%20sch%u016Fze
55984,0,1339452000,129,25,10,15,179,A,Po%u0159ad%20sch%u016Fze
55985,0,1339452000,174,2,2,2,180,A,Po%u0159ad%20sch%u016Fze
55986,0,1339452000,82,77,8,13,180,R,Po%u0159ad%20sch%u016Fze
55987,0,1339452000,146,2,26,6,180,A,Po%u0159ad%20sch%u016Fze
55988,0,1339452000,143,21,11,5,180,A,Po%u0159ad%20sch%u016Fze
55989,0,1339452000,150,3,24,3,180,A,Po%u0159ad%20sch%u016Fze
55990,0,1339452000,99,54,26,2,181,A,Po%u0159ad%20sch%u016Fze
55991,0,1339452000,88,79,7,6,180,R,Po%u0159ad%20sch%u016Fze
55992,0,1339452000,97,53,12,18,180,A,Po%u0159ad%20sch%u016Fze
55993,0,1339452000,169,0,10,2,181,A,Po%u0159ad%20sch%u016Fze
55994,0,1339452000,96,76,4,5,181,A,Po%u0159ad%20sch%u016Fze
55995,0,1339452000,125,52,5,0,182,A,Po%u0159ad%20sch%u016Fze
55996,98,1339452000,134,33,10,10,187,A,Vl.n.p%u016Fsob.sil%20MO%20%u010CR%20v%20zahr.operac%EDch%20v%20letech%202013%20a%202014
55997,98,1339452000,155,4,25,3,187,A,Vl.n.p%u016Fsob.sil%20MO%20%u010CR%20v%20zahr.operac%EDch%20v%20letech%202013%20a%202014
55998,99,1339452000,122,26,33,3,184,A,Inf.%20o%20p%u0159eletech%20a%20pr%u016Fjezdech%20ve%202.%20pololet%ED%202011
55999,100,1339452000,145,1,33,4,183,A,Inf.%20o%20vojensk%FDch%20cvi%u010Den%EDch%20A%u010CR%20%u010Dervenec%20-%20prosinec%202011
56000,117,1339452000,94,37,14,9,154,A,%u017D%E1dost%20o%20vysloven%ED%20souhlasu%20Poslaneck%E9%20sn%u011Bmovny%20k%20trestn%EDmu%20st%EDh%E1n%ED%20po
56001,37,1339452000,80,78,0,0,158,A,Novela%20z.%20-%20z%E1kon%EDk%20pr%E1ce
56002,47,1339452000,71,70,3,1,145,R,Novela%20z.%20o%20spot%u0159ebn%EDch%20dan%EDch
56003,47,1339452000,111,21,15,4,151,A,Novela%20z.%20o%20spot%u0159ebn%EDch%20dan%EDch
56004,47,1339452000,82,70,1,0,153,A,Novela%20z.%20o%20spot%u0159ebn%EDch%20dan%EDch
56005,6,1339452000,74,21,41,12,148,R,Novela%20z.%20o%20hospoda%u0159en%ED%20energi%ED%20-%20EU
56006,6,1339452000,104,9,10,2,125,A,Novela%20z.%20o%20hospoda%u0159en%ED%20energi%ED%20-%20EU
56007,6,1339452000,81,31,6,9,127,A,Novela%20z.%20o%20hospoda%u0159en%ED%20energi%ED%20-%20EU
56008,60,1339452000,66,55,1,1,123,A,Novela%20z.%20o%20zam%u011Bstnanosti
56009,0,1339538400,139,12,31,5,187,A,Po%u0159ad%20sch%u016Fze
56010,0,1339538400,147,3,31,6,187,A,Po%u0159ad%20sch%u016Fze
56011,85,1339538400,178,0,7,2,187,A,N.z.%20o%20volb%u011B%20prezidenta%20republiky
56012,85,1339538400,171,0,11,4,186,A,N.z.%20o%20volb%u011B%20prezidenta%20republiky
56013,86,1339538400,176,0,11,0,187,A,Novela%20z.%20o%20spr%E1vn%EDch%20poplatc%EDch
56014,88,1339538400,90,94,9,1,194,R,Novela%20z.%20o%20d%u016Fchodov%E9m%20poji%u0161t%u011Bn%ED
56015,88,1339538400,22,85,37,41,185,R,Novela%20z.%20o%20d%u016Fchodov%E9m%20poji%u0161t%u011Bn%ED
56016,88,1339538400,95,89,0,2,186,A,Novela%20z.%20o%20d%u016Fchodov%E9m%20poji%u0161t%u011Bn%ED
56017,78,1339538400,71,93,18,4,186,R,Novela%20z.%20o%20soci%E1ln%u011B-pr%E1vn%ED%20ochran%u011B%20d%u011Bt%ED
56018,78,1339538400,178,1,6,0,185,A,Novela%20z.%20o%20soci%E1ln%u011B-pr%E1vn%ED%20ochran%u011B%20d%u011Bt%ED
56019,78,1339538400,182,0,2,1,185,A,Novela%20z.%20o%20soci%E1ln%u011B-pr%E1vn%ED%20ochran%u011B%20d%u011Bt%ED
56020,78,1339538400,181,0,4,0,185,A,Novela%20z.%20o%20soci%E1ln%u011B-pr%E1vn%ED%20ochran%u011B%20d%u011Bt%ED
56021,78,1339538400,70,100,10,5,185,R,Novela%20z.%20o%20soci%E1ln%u011B-pr%E1vn%ED%20ochran%u011B%20d%u011Bt%ED
56022,78,1339538400,14,102,37,31,184,R,Novela%20z.%20o%20soci%E1ln%u011B-pr%E1vn%ED%20ochran%u011B%20d%u011Bt%ED
56023,78,1339538400,136,3,21,25,185,A,Novela%20z.%20o%20soci%E1ln%u011B-pr%E1vn%ED%20ochran%u011B%20d%u011Bt%ED
56024,78,1339538400,103,17,39,26,185,A,Novela%20z.%20o%20soci%E1ln%u011B-pr%E1vn%ED%20ochran%u011B%20d%u011Bt%ED
56025,78,1339538400,113,19,32,23,187,A,Novela%20z.%20o%20soci%E1ln%u011B-pr%E1vn%ED%20ochran%u011B%20d%u011Bt%ED
56026,78,1339538400,98,32,29,26,185,A,Novela%20z.%20o%20soci%E1ln%u011B-pr%E1vn%ED%20ochran%u011B%20d%u011Bt%ED
56027,76,1339538400,177,1,5,0,183,A,Novela%20z.%20-%20ob%u010Dansk%FD%20soudn%ED%20%u0159%E1d
56028,76,1339538400,105,41,11,27,184,A,Novela%20z.%20-%20ob%u010Dansk%FD%20soudn%ED%20%u0159%E1d
56029,76,1339538400,81,39,17,47,184,R,Novela%20z.%20-%20ob%u010Dansk%FD%20soudn%ED%20%u0159%E1d
56030,76,1339538400,179,1,4,1,185,A,Novela%20z.%20-%20ob%u010Dansk%FD%20soudn%ED%20%u0159%E1d
56031,76,1339538400,76,72,28,9,185,R,Novela%20z.%20-%20ob%u010Dansk%FD%20soudn%ED%20%u0159%E1d
56032,76,1339538400,40,94,35,16,185,R,Novela%20z.%20-%20ob%u010Dansk%FD%20soudn%ED%20%u0159%E1d
56033,76,1339538400,97,83,5,0,185,A,Novela%20z.%20-%20ob%u010Dansk%FD%20soudn%ED%20%u0159%E1d
56034,76,1339538400,89,90,4,2,185,R,Novela%20z.%20-%20ob%u010Dansk%FD%20soudn%ED%20%u0159%E1d
56035,76,1339538400,99,81,4,2,186,A,Novela%20z.%20-%20ob%u010Dansk%FD%20soudn%ED%20%u0159%E1d
56036,81,1339538400,163,2,18,0,183,A,Novela%20z.%20-%20trestn%ED%20z%E1kon%EDk
56037,81,1339538400,167,1,15,0,183,A,Novela%20z.%20-%20trestn%ED%20z%E1kon%EDk
56038,81,1339538400,138,24,19,2,183,A,Novela%20z.%20-%20trestn%ED%20z%E1kon%EDk
56039,81,1339538400,163,0,18,1,182,A,Novela%20z.%20-%20trestn%ED%20z%E1kon%EDk
56040,81,1339538400,136,24,17,5,182,A,Novela%20z.%20-%20trestn%ED%20z%E1kon%EDk
56041,81,1339538400,89,79,13,1,182,R,Novela%20z.%20-%20trestn%ED%20z%E1kon%EDk
56042,81,1339538400,153,5,23,1,182,A,Novela%20z.%20-%20trestn%ED%20z%E1kon%EDk
56043,81,1339538400,93,76,1,1,171,A,Novela%20z.%20-%20trestn%ED%20z%E1kon%EDk
56044,0,1339624800,109,0,8,0,117,A,Po%u0159ad%20sch%u016Fze
56045,0,1339624800,68,29,22,3,122,A,Po%u0159ad%20sch%u016Fze
56046,0,1339624800,59,64,4,0,127,R,Po%u0159ad%20sch%u016Fze
56047,101,1339624800,97,8,34,2,141,A,V%FDro%u010Dn%ED%20zpr%E1va%20o%20%u010Dinnosti%20a%20%FA%u010Detn%ED%20z%E1v%u011Brka%20SFDI%20za%20rok%202011
56048,118,1339624800,91,1,48,1,141,A,Na%u0159%EDzen%ED%20Rady%20-%20program%20Evropa%20pro%20ob%u010Dany
56049,41,1339624800,118,0,33,0,151,A,N.z.o%20zm%u011Bn%u011B%20pr%E1vn%ED%20formy%20ob%u010Dansk%E9ho%20sdru%u017Een%ED
56050,58,1339624800,119,0,29,0,148,A,Vl.n.z.%20o%20St%E1tn%EDm%20pozemkov%E9m%20%FA%u0159adu
56051,58,1339624800,57,58,30,2,147,R,Vl.n.z.%20o%20St%E1tn%EDm%20pozemkov%E9m%20%FA%u0159adu
56052,65,1339624800,102,1,42,1,146,A,Zm%u011Bna%20p%u0159%EDlohy%20A%20Stockholmsk%E9%20%FAml.o%20perzist.organ.polutantech
56053,67,1339624800,100,0,50,0,150,A,Sml.mezi%20%u010CR%20a%20Rakouskou%20rep.%20o%20zamezen%ED%20dvoj%EDmu%20zdan%u011Bn%ED
56054,68,1339624800,91,0,59,0,150,A,T%u0159et%ED%20dodatkov%FD%20protokol%20k%20Evropsk%E9%20%FAmluv%u011B%20o%20vyd%E1v%E1n%ED
56055,69,1339624800,104,0,46,0,150,A,Smlouva%20Kolum.rep.-%u010CR%20dvoj%ED%20zdan%u011Bn%ED
56056,70,1339624800,95,0,54,0,149,A,Sml.mezi%20%u010CR%20a%20vl.%20Kr%E1l.%20Sa%FAdsk%E9%20Ar%E1bie%20o%20zamez.dvoj.zdan%u011Bn%ED
56057,104,1339624800,87,1,61,3,152,A,V%FDro%u010Dn%ED%20zpr%E1va%20Rady%20%u010Cesk%E9ho%20rozhlasu%20za%20rok%202011
56058,105,1339624800,69,27,54,3,153,R,V%FDro%u010Dn%ED%20zpr%E1va%20o%20%u010Dinnosti%20%u010Cesk%E9%20televize%20za%20rok%202011
56059,105,1339624800,103,4,45,1,153,A,V%FDro%u010Dn%ED%20zpr%E1va%20o%20%u010Dinnosti%20%u010Cesk%E9%20televize%20za%20rok%202011
56060,105,1339624800,84,22,4,8,118,A,V%FDro%u010Dn%ED%20zpr%E1va%20o%20%u010Dinnosti%20%u010Cesk%E9%20televize%20za%20rok%202011
56061,106,1339624800,73,11,26,12,122,A,V%FDro%u010Dn%ED%20zpr%E1va%20%u010Cesk%E9ho%20telekomunika%u010Dn%EDho%20%FA%u0159adu%20za%20rok%202011
56062,107,1339624800,112,1,14,1,128,A,Zpr%E1va%20o%20%u010Dinnosti%20finan%u010Dn%EDho%20arbitra%20za%20rok%202011
56063,108,1339624800,106,2,26,2,136,A,Inf.%20o%20realizaci%20protipovod%u0148ov%FDch%20opat%u0159en%ED%20v%20%u010CR%20za%20rok%202011
56064,109,1339624800,55,56,21,3,135,R,N%E1vrh%20st%E1tn%EDho%20z%E1v%u011Bre%u010Dn%E9ho%20%FA%u010Dtu%20%u010CR%20za%20rok%202011
56065,109,1339624800,128,0,12,0,140,A,N%E1vrh%20st%E1tn%EDho%20z%E1v%u011Bre%u010Dn%E9ho%20%FA%u010Dtu%20%u010CR%20za%20rok%202011
56066,109,1339624800,65,69,2,2,138,R,N%E1vrh%20st%E1tn%EDho%20z%E1v%u011Bre%u010Dn%E9ho%20%FA%u010Dtu%20%u010CR%20za%20rok%202011
56067,109,1339624800,81,62,14,5,162,R,N%E1vrh%20st%E1tn%EDho%20z%E1v%u011Bre%u010Dn%E9ho%20%FA%u010Dtu%20%u010CR%20za%20rok%202011
56068,109,1339624800,129,6,16,2,153,A,N%E1vrh%20st%E1tn%EDho%20z%E1v%u011Bre%u010Dn%E9ho%20%FA%u010Dtu%20%u010CR%20za%20rok%202011
56069,109,1339624800,83,71,1,2,157,A,N%E1vrh%20st%E1tn%EDho%20z%E1v%u011Bre%u010Dn%E9ho%20%FA%u010Dtu%20%u010CR%20za%20rok%202011
56070,110,1339624800,85,14,40,17,156,A,P%u0159ehled%20o%20%u010Dinnosti%20cenov%FDch%20kontroln%EDch%20org%E1n%u016F%20za%20rok%202011
56071,111,1339624800,129,2,24,0,155,A,Ro%u010Dn%ED%20%FA%u010Detn%ED%20z%E1v%u011Brka%20a%20v%FDro%u010Dn%ED%20zpr%E1va%20SFRB%20za%20rok%202011
56072,112,1339624800,110,7,28,10,155,A,Stanoven%ED%20v%FD%u0161e%20odm%u011Bny%20%u010Dlen%u016Fm%20Kontroln%ED%20rady%20Technologick%E9%20agentury%20%u010CR
56073,113,1339624800,107,7,37,4,155,A,N%E1vrh%20na%20zm%u011Bny%20zasedac%EDho%20po%u0159%E1dku%20PS
56074,16,1339624800,114,2,33,4,153,A,Novela%20z.%20o%20st%E1tn%ED%20soci%E1ln%ED%20podpo%u0159e
56075,0,1339711200,72,68,15,6,161,R,Po%u0159ad%20sch%u016Fze
56076,0,1339711200,129,23,7,3,162,A,Po%u0159ad%20sch%u016Fze
56077,0,1339711200,86,16,32,28,162,A,Po%u0159ad%20sch%u016Fze
56078,0,1339711200,85,20,32,26,163,A,Po%u0159ad%20sch%u016Fze
56079,0,1339711200,83,44,23,13,163,A,Po%u0159ad%20sch%u016Fze
56080,0,1339711200,84,73,3,2,162,A,Po%u0159ad%20sch%u016Fze
56081,103,1339711200,145,3,12,3,163,A,Ro%u010Dn%ED%20zpr%E1va%20o%20v%FDsledku%20hospoda%u0159en%ED%20%u010CNB%20za%20rok%202011
56082,103,1339711200,114,4,41,3,162,A,Ro%u010Dn%ED%20zpr%E1va%20o%20v%FDsledku%20hospoda%u0159en%ED%20%u010CNB%20za%20rok%202011
56083,73,1339711200,153,2,8,2,165,A,Novela%20z.%20o%20%FAzemn%EDm%20pl%E1nov.%20a%20staveb.%20%u0159%E1du%20%28stavebn%ED%20z%E1kon%29%20-%20EU
56084,73,1339711200,163,1,2,0,166,A,Novela%20z.%20o%20%FAzemn%EDm%20pl%E1nov.%20a%20staveb.%20%u0159%E1du%20%28stavebn%ED%20z%E1kon%29%20-%20EU
56085,73,1339711200,164,0,1,1,166,A,Novela%20z.%20o%20%FAzemn%EDm%20pl%E1nov.%20a%20staveb.%20%u0159%E1du%20%28stavebn%ED%20z%E1kon%29%20-%20EU
56086,73,1339711200,88,44,12,20,164,A,Novela%20z.%20o%20%FAzemn%EDm%20pl%E1nov.%20a%20staveb.%20%u0159%E1du%20%28stavebn%ED%20z%E1kon%29%20-%20EU
56087,73,1339711200,161,0,2,3,166,A,Novela%20z.%20o%20%FAzemn%EDm%20pl%E1nov.%20a%20staveb.%20%u0159%E1du%20%28stavebn%ED%20z%E1kon%29%20-%20EU
56088,73,1339711200,150,1,5,6,162,A,Novela%20z.%20o%20%FAzemn%EDm%20pl%E1nov.%20a%20staveb.%20%u0159%E1du%20%28stavebn%ED%20z%E1kon%29%20-%20EU
56089,73,1339711200,154,0,4,6,164,A,Novela%20z.%20o%20%FAzemn%EDm%20pl%E1nov.%20a%20staveb.%20%u0159%E1du%20%28stavebn%ED%20z%E1kon%29%20-%20EU
56090,73,1339711200,1,148,6,9,164,R,Novela%20z.%20o%20%FAzemn%EDm%20pl%E1nov.%20a%20staveb.%20%u0159%E1du%20%28stavebn%ED%20z%E1kon%29%20-%20EU
56091,73,1339711200,9,115,28,11,163,R,Novela%20z.%20o%20%FAzemn%EDm%20pl%E1nov.%20a%20staveb.%20%u0159%E1du%20%28stavebn%ED%20z%E1kon%29%20-%20EU
56092,73,1339711200,1,143,10,9,163,R,Novela%20z.%20o%20%FAzemn%EDm%20pl%E1nov.%20a%20staveb.%20%u0159%E1du%20%28stavebn%ED%20z%E1kon%29%20-%20EU
56093,73,1339711200,13,131,8,11,163,R,Novela%20z.%20o%20%FAzemn%EDm%20pl%E1nov.%20a%20staveb.%20%u0159%E1du%20%28stavebn%ED%20z%E1kon%29%20-%20EU
56094,73,1339711200,118,4,26,17,165,A,Novela%20z.%20o%20%FAzemn%EDm%20pl%E1nov.%20a%20staveb.%20%u0159%E1du%20%28stavebn%ED%20z%E1kon%29%20-%20EU
56095,120,1339711200,124,0,36,2,162,A,N%E1vrhy%20Poslaneck%E9%20sn%u011Bmovny%20na%20prop%u016Fj%u010Den%ED%20nebo%20ud%u011Blen%ED%20st%E1tn%EDch%20vyzname
56096,120,1339711200,124,0,37,1,162,A,N%E1vrhy%20Poslaneck%E9%20sn%u011Bmovny%20na%20prop%u016Fj%u010Den%ED%20nebo%20ud%u011Blen%ED%20st%E1tn%EDch%20vyzname
56097,120,1339711200,119,0,20,2,141,A,N%E1vrhy%20Poslaneck%E9%20sn%u011Bmovny%20na%20prop%u016Fj%u010Den%ED%20nebo%20ud%u011Blen%ED%20st%E1tn%EDch%20vyzname
56098,79,1339711200,123,1,25,1,150,A,Novela%20z.%20o%20v%FDkonu%20%FAstavn%ED%20v%FDchovy
56099,79,1339711200,61,67,20,5,153,R,Novela%20z.%20o%20v%FDkonu%20%FAstavn%ED%20v%FDchovy
56100,79,1339711200,61,85,8,2,156,R,Novela%20z.%20o%20v%FDkonu%20%FAstavn%ED%20v%FDchovy
56101,79,1339711200,146,0,9,1,156,A,Novela%20z.%20o%20v%FDkonu%20%FAstavn%ED%20v%FDchovy
56102,79,1339711200,143,2,6,5,156,A,Novela%20z.%20o%20v%FDkonu%20%FAstavn%ED%20v%FDchovy
56103,30,1339711200,59,89,1,1,150,R,Vl.n.z.%20o%20pojistn%E9m%20na%20d%u016Fchodov%E9%20spo%u0159en%ED%20-%20EU
56104,30,1339711200,149,2,0,1,152,A,Vl.n.z.%20o%20pojistn%E9m%20na%20d%u016Fchodov%E9%20spo%u0159en%ED%20-%20EU
56105,30,1339711200,82,64,5,1,152,A,Vl.n.z.%20o%20pojistn%E9m%20na%20d%u016Fchodov%E9%20spo%u0159en%ED%20-%20EU
56106,31,1339711200,61,87,4,1,153,R,Vl.n.z.o%20pojistn%E9m%20na%20d%u016Fchodov%E9%20spo%u0159en%ED%20-%20souvisej%EDc%ED%20-%20EU
56107,31,1339711200,145,2,5,1,153,A,Vl.n.z.o%20pojistn%E9m%20na%20d%u016Fchodov%E9%20spo%u0159en%ED%20-%20souvisej%EDc%ED%20-%20EU
56108,31,1339711200,81,65,5,2,153,A,Vl.n.z.o%20pojistn%E9m%20na%20d%u016Fchodov%E9%20spo%u0159en%ED%20-%20souvisej%EDc%ED%20-%20EU
56109,0,1340143200,156,2,9,0,167,A,Po%u0159ad%20sch%u016Fze
56110,0,1340143200,155,1,10,2,168,A,Po%u0159ad%20sch%u016Fze
56111,0,1340143200,148,2,14,4,168,A,Po%u0159ad%20sch%u016Fze
56112,0,1340143200,153,1,13,1,168,A,Po%u0159ad%20sch%u016Fze
56113,0,1340143200,113,12,25,18,168,A,Po%u0159ad%20sch%u016Fze
56114,0,1340143200,148,5,12,4,169,A,Po%u0159ad%20sch%u016Fze
56115,121,1340143200,151,1,14,1,167,A,Novela%20z.%20o%20St%E1tn%EDm%20fondu%20rozvoje%20bydlen%ED
56116,121,1340143200,153,0,14,1,168,A,Novela%20z.%20o%20St%E1tn%EDm%20fondu%20rozvoje%20bydlen%ED
56117,71,1340143200,150,0,16,2,168,A,Novela%20z.%20o%20elektronick%FDch%20komunikac%EDch%20-%20EU
56118,71,1340143200,154,0,13,0,167,A,Novela%20z.%20o%20elektronick%FDch%20komunikac%EDch%20-%20EU
56119,72,1340143200,154,1,14,0,169,A,Novela%20z.%20o%20hospoda%u0159en%ED%20energi%ED%20-%20EU
56120,72,1340143200,160,2,5,2,169,A,Novela%20z.%20o%20hospoda%u0159en%ED%20energi%ED%20-%20EU
56121,72,1340143200,92,18,19,40,169,A,Novela%20z.%20o%20hospoda%u0159en%ED%20energi%ED%20-%20EU
56122,72,1340143200,152,3,14,1,170,A,Novela%20z.%20o%20hospoda%u0159en%ED%20energi%ED%20-%20EU
56123,72,1340143200,54,18,46,52,170,R,Novela%20z.%20o%20hospoda%u0159en%ED%20energi%ED%20-%20EU
56124,72,1340143200,155,2,7,6,170,A,Novela%20z.%20o%20hospoda%u0159en%ED%20energi%ED%20-%20EU
56125,72,1340143200,122,8,13,27,170,A,Novela%20z.%20o%20hospoda%u0159en%ED%20energi%ED%20-%20EU
56126,72,1340143200,6,98,41,25,170,R,Novela%20z.%20o%20hospoda%u0159en%ED%20energi%ED%20-%20EU
56127,72,1340143200,2,128,32,8,170,R,Novela%20z.%20o%20hospoda%u0159en%ED%20energi%ED%20-%20EU
56128,72,1340143200,150,1,11,8,170,A,Novela%20z.%20o%20hospoda%u0159en%ED%20energi%ED%20-%20EU
56129,72,1340143200,93,9,37,31,170,A,Novela%20z.%20o%20hospoda%u0159en%ED%20energi%ED%20-%20EU
56130,82,1340143200,77,70,20,1,168,R,Novela%20z.%20o%20st%E1tn%ED%20soci%E1ln%ED%20podpo%u0159e
56131,82,1340143200,151,2,7,0,160,A,Novela%20z.%20o%20st%E1tn%ED%20soci%E1ln%ED%20podpo%u0159e
56132,82,1340143200,137,0,22,3,162,A,Novela%20z.%20o%20st%E1tn%ED%20soci%E1ln%ED%20podpo%u0159e
56133,82,1340143200,93,60,5,4,162,A,Novela%20z.%20o%20st%E1tn%ED%20soci%E1ln%ED%20podpo%u0159e
56134,82,1340143200,157,4,0,1,162,A,Novela%20z.%20o%20st%E1tn%ED%20soci%E1ln%ED%20podpo%u0159e
56135,82,1340143200,78,76,2,6,162,R,Novela%20z.%20o%20st%E1tn%ED%20soci%E1ln%ED%20podpo%u0159e
56136,82,1340143200,83,77,1,1,162,A,Novela%20z.%20o%20st%E1tn%ED%20soci%E1ln%ED%20podpo%u0159e
56137,82,1340143200,139,3,21,1,164,A,Novela%20z.%20o%20st%E1tn%ED%20soci%E1ln%ED%20podpo%u0159e
56138,82,1340143200,81,82,0,2,165,R,Novela%20z.%20o%20st%E1tn%ED%20soci%E1ln%ED%20podpo%u0159e
56139,82,1340143200,162,0,1,2,165,A,Novela%20z.%20o%20st%E1tn%ED%20soci%E1ln%ED%20podpo%u0159e
56140,82,1340143200,126,9,7,23,165,A,Novela%20z.%20o%20st%E1tn%ED%20soci%E1ln%ED%20podpo%u0159e
56141,80,1340143200,76,71,1,0,148,A,Vl.n.z.%20o%20majetkov%E9m%20vyrovn%E1n%ED%20s%20c%EDrkvemi%20a%20n%E1bo%u017Een.%20spole%u010D.
56142,80,1340143200,114,8,21,16,159,A,Vl.n.z.%20o%20majetkov%E9m%20vyrovn%E1n%ED%20s%20c%EDrkvemi%20a%20n%E1bo%u017Een.%20spole%u010D.
56143,80,1340143200,80,78,1,0,159,A,Vl.n.z.%20o%20majetkov%E9m%20vyrovn%E1n%ED%20s%20c%EDrkvemi%20a%20n%E1bo%u017Een.%20spole%u010D.
56144,80,1340143200,91,39,23,9,162,A,Vl.n.z.%20o%20majetkov%E9m%20vyrovn%E1n%ED%20s%20c%EDrkvemi%20a%20n%E1bo%u017Een.%20spole%u010D.
56145,80,1340143200,80,81,1,0,162,R,Vl.n.z.%20o%20majetkov%E9m%20vyrovn%E1n%ED%20s%20c%EDrkvemi%20a%20n%E1bo%u017Een.%20spole%u010D.
56146,116,1340143200,107,5,28,12,152,A,Vl.%20n.%20z.%2C%20kter%FDm%20se%20m%u011Bn%ED%20volebn%ED%20z%E1kony%20-%20EU
56147,18,1340143200,34,81,28,12,155,R,Novela%20z.%20-%20insolven%u010Dn%ED%20z%E1kon
56148,34,1340143200,105,0,46,0,151,A,Novela%20z.%20-%20z%E1kon%EDk%20pr%E1ce
56149,91,1340143200,133,0,20,0,153,A,N%E1vrh%20na%20zm%u011Bny%20ve%20slo%u017Een%ED%20org%E1n%u016F%20Poslaneck%E9%20sn%u011Bmovny
56150,91,1340143200,132,1,18,2,153,A,N%E1vrh%20na%20zm%u011Bny%20ve%20slo%u017Een%ED%20org%E1n%u016F%20Poslaneck%E9%20sn%u011Bmovny
56151,92,1340143200,97,27,5,9,138,A,Volba%20kandid%E1ta%20na%20prezidenta%20NK%DA
56152,93,1340143200,130,2,5,0,137,A,N%E1vrh%20na%20volbu%20%u010Dlen%u016F%20Rady%20%u010Cesk%E9%20televize
56153,94,1340143200,128,1,6,1,136,A,N%E1vrh%20na%20volbu%20%u010Dlen%u016F%20Rady%20%u010Cesk%E9ho%20rozhlasu
56154,95,1340143200,127,0,8,1,136,A,Volba%20%u010Dlen%u016F%20Rady%20%u010Cesk%E9%20tiskov%E9%20kancel%E1%u0159e
56155,96,1340143200,126,0,9,1,136,A,N%E1vrh%20na%20jmenov%E1n%ED%20%u010Dlena%20RRTV
56156,97,1340143200,123,0,13,1,137,A,N%E1vrh%20na%20volbu%20kandid%E1ta%20na%20%u010Dlena%20R%DASTR
56157,49,1340143200,94,0,36,0,130,A,Novela%20z.%20o%20vysok%FDch%20%u0161kol%E1ch
56158,57,1340143200,55,63,4,0,122,R,Vl.n.z.%20o%20zru%u0161en%ED%20z%E1kona%20o%20%FArazov%E9m%20poji%u0161t%u011Bn%ED%20zam%u011Bstnanc%u016F
56159,57,1340143200,118,1,2,1,122,A,Vl.n.z.%20o%20zru%u0161en%ED%20z%E1kona%20o%20%FArazov%E9m%20poji%u0161t%u011Bn%ED%20zam%u011Bstnanc%u016F
56160,57,1340143200,55,50,7,11,123,R,Vl.n.z.%20o%20zru%u0161en%ED%20z%E1kona%20o%20%FArazov%E9m%20poji%u0161t%u011Bn%ED%20zam%u011Bstnanc%u016F
56161,57,1340143200,64,56,3,0,123,A,Vl.n.z.%20o%20zru%u0161en%ED%20z%E1kona%20o%20%FArazov%E9m%20poji%u0161t%u011Bn%ED%20zam%u011Bstnanc%u016F
56162,80,1340316000,65,71,4,1,141,R,Vl.n.z.%20o%20majetkov%E9m%20vyrovn%E1n%ED%20s%20c%EDrkvemi%20a%20n%E1bo%u017Een.%20spole%u010D.
56163,80,1340316000,66,71,0,0,137,R,Vl.n.z.%20o%20majetkov%E9m%20vyrovn%E1n%ED%20s%20c%EDrkvemi%20a%20n%E1bo%u017Een.%20spole%u010D.
56164,80,1340316000,64,70,1,0,135,R,Vl.n.z.%20o%20majetkov%E9m%20vyrovn%E1n%ED%20s%20c%EDrkvemi%20a%20n%E1bo%u017Een.%20spole%u010D.
56165,80,1340316000,60,69,1,0,130,R,Vl.n.z.%20o%20majetkov%E9m%20vyrovn%E1n%ED%20s%20c%EDrkvemi%20a%20n%E1bo%u017Een.%20spole%u010D.
56166,0,1340316000,118,3,7,1,129,A,%20
56167,0,1341871200,144,1,15,1,161,A,%20
56168,0,1341871200,170,1,5,0,176,A,Po%u0159ad%20sch%u016Fze
56169,0,1341871200,175,1,1,0,177,A,Po%u0159ad%20sch%u016Fze
56170,0,1341871200,85,83,6,4,178,R,Po%u0159ad%20sch%u016Fze
56171,0,1341871200,163,4,9,2,178,A,Po%u0159ad%20sch%u016Fze
56172,0,1341871200,96,71,6,5,178,A,Po%u0159ad%20sch%u016Fze
56173,0,1341871200,144,8,21,6,179,A,Po%u0159ad%20sch%u016Fze
56174,0,1341871200,28,9,142,0,179,R,Po%u0159ad%20sch%u016Fze
56175,0,1341871200,94,81,4,0,179,A,Po%u0159ad%20sch%u016Fze
56176,0,1341871200,80,83,4,11,178,R,Po%u0159ad%20sch%u016Fze
56177,0,1341871200,92,57,26,3,178,A,Po%u0159ad%20sch%u016Fze
56178,1,1341871200,95,51,28,4,178,A,Novela%20z.%20o%20p%u0159estupc%EDch
56179,2,1341871200,96,41,37,4,178,A,Novela%20z.%20na%20ochranu%20zv%ED%u0159at%20proti%20t%FDr%E1n%ED%20-%20EU
56180,3,1341871200,118,14,25,4,161,A,Novela%20z.%20o%20rozpo%u010Dtov%E9m%20ur%u010Den%ED%20dan%ED
56181,4,1341871200,82,75,1,1,159,A,Vl.n.z.o%20zm%u011Bn%u011B%20da%u0148ov%FDch%2C%20pojistn%FDch%20a%20dal%u0161%EDch%20z%E1kon%u016F%20-%20EU
56182,5,1341871200,150,4,13,5,172,A,Novela%20z.%20-%20%DAstava%20%u010Cesk%E9%20republiky
56183,6,1341871200,66,65,38,5,174,R,Novela%20z.%20-%20horn%ED%20z%E1kon
56184,6,1341871200,65,86,21,1,173,R,Novela%20z.%20-%20horn%ED%20z%E1kon
56185,6,1341871200,69,95,2,3,169,R,Novela%20z.%20-%20horn%ED%20z%E1kon
56186,6,1341871200,70,100,0,2,172,R,Novela%20z.%20-%20horn%ED%20z%E1kon
56187,6,1341871200,68,98,5,2,173,R,Novela%20z.%20-%20horn%ED%20z%E1kon
56188,6,1341871200,170,3,2,0,175,A,Novela%20z.%20-%20horn%ED%20z%E1kon
56189,6,1341871200,140,15,15,6,176,A,Novela%20z.%20-%20horn%ED%20z%E1kon
56190,7,1341871200,131,0,45,0,176,A,Novela%20z.%20-%20%u0161kolsk%FD%20z%E1kon
56191,7,1341871200,112,10,49,5,176,A,Novela%20z.%20-%20%u0161kolsk%FD%20z%E1kon
56192,8,1341871200,141,0,2,0,143,A,Novela%20z.%20o%20pojistn%E9m%20na%20v%u0161eobecn%E9%20zdravotn%ED%20poji%u0161t%u011Bn%ED
56193,0,1341957600,157,3,6,1,167,A,Po%u0159ad%20sch%u016Fze
56194,10,1341957600,157,1,16,1,175,A,Novela%20z.%20o%20soci%E1ln%EDch%20slu%u017Eb%E1ch
56195,10,1341957600,121,16,17,21,175,A,Novela%20z.%20o%20soci%E1ln%EDch%20slu%u017Eb%E1ch
56196,9,1341957600,89,83,4,2,178,R,Novela%20z.%20-%20z%E1kon%EDk%20pr%E1ce
56197,9,1341957600,137,17,22,2,178,A,Novela%20z.%20-%20z%E1kon%EDk%20pr%E1ce
56198,9,1341957600,94,82,0,1,177,A,Novela%20z.%20-%20z%E1kon%EDk%20pr%E1ce
56199,9,1341957600,170,1,5,1,177,A,Novela%20z.%20-%20z%E1kon%EDk%20pr%E1ce
56200,9,1341957600,92,85,0,0,177,A,Novela%20z.%20-%20z%E1kon%EDk%20pr%E1ce
56201,11,1341957600,132,1,41,2,176,A,Novela%20z.%20o%20dani%20z%20p%u0159idan%E9%20hodnoty%20-%20EU
56202,12,1341957600,160,1,15,1,177,A,Novela%20z.%20o%20spot%u0159ebn%EDch%20dan%EDch%20-%20EU
56203,12,1341957600,78,67,22,10,177,R,Novela%20z.%20o%20spot%u0159ebn%EDch%20dan%EDch%20-%20EU
56204,12,1341957600,83,42,27,25,177,R,Novela%20z.%20o%20spot%u0159ebn%EDch%20dan%EDch%20-%20EU
56205,13,1341957600,136,0,38,1,175,A,Novela%20z.%20o%20dopl%u0148kov%E9m%20penzijn%EDm%20spo%u0159en%ED
56206,14,1341957600,136,0,42,0,178,A,Novela%20z.%20-%20ob%u010Dansk%FD%20soudn%ED%20%u0159%E1d%20-%20EU
56207,18,1341957600,161,0,18,0,179,A,Novela%20z.%20-%20insolven%u010Dn%ED%20z%E1kon
56208,18,1341957600,5,2,172,0,179,R,Novela%20z.%20-%20insolven%u010Dn%ED%20z%E1kon
56209,18,1341957600,42,91,24,22,179,R,Novela%20z.%20-%20insolven%u010Dn%ED%20z%E1kon
56210,18,1341957600,150,10,16,3,179,A,Novela%20z.%20-%20insolven%u010Dn%ED%20z%E1kon
56211,19,1341957600,145,1,28,2,176,A,Novela%20z.%20o%20ochran%u011B%20hospod%E1%u0159sk%E9%20sout%u011B%u017Ee
56212,19,1341957600,108,49,15,6,178,A,Novela%20z.%20o%20ochran%u011B%20hospod%E1%u0159sk%E9%20sout%u011B%u017Ee
56213,19,1341957600,57,85,31,5,178,R,Novela%20z.%20o%20ochran%u011B%20hospod%E1%u0159sk%E9%20sout%u011B%u017Ee
56214,19,1341957600,150,3,6,5,164,A,Novela%20z.%20o%20ochran%u011B%20hospod%E1%u0159sk%E9%20sout%u011B%u017Ee
56215,20,1341957600,10,17,136,0,163,R,Vl.n.z.%20o%20majetkov%E9m%20vyrovn%E1n%ED%20s%20c%EDrkvemi%20a%20n%E1bo%u017Een.%20spole%u010D.
56216,20,1341957600,76,84,1,0,161,R,Vl.n.z.%20o%20majetkov%E9m%20vyrovn%E1n%ED%20s%20c%EDrkvemi%20a%20n%E1bo%u017Een.%20spole%u010D.
56217,20,1341957600,81,66,11,10,168,R,Vl.n.z.%20o%20majetkov%E9m%20vyrovn%E1n%ED%20s%20c%EDrkvemi%20a%20n%E1bo%u017Een.%20spole%u010D.
56218,20,1341957600,82,89,0,0,171,R,Vl.n.z.%20o%20majetkov%E9m%20vyrovn%E1n%ED%20s%20c%EDrkvemi%20a%20n%E1bo%u017Een.%20spole%u010D.
56219,23,1341957600,117,45,4,10,176,A,%u017D%E1dost%20o%20vysloven%ED%20souhlasu%20PS%20k%20trestn%EDmu%20st%EDh%E1n%ED%20Vlasty%20Parkanov%E9
56220,0,1342130400,159,14,4,5,182,A,Po%u0159ad%20sch%u016Fze
56221,0,1342130400,152,0,28,3,183,A,Po%u0159ad%20sch%u016Fze
56222,0,1342130400,148,2,28,6,184,A,Po%u0159ad%20sch%u016Fze
56223,22,1342130400,91,90,2,2,185,R,Vl.n.z.o%20zm%u011Bn%u011B%20da%u0148ov%FDch%2C%20pojistn%FDch%20a%20dal%u0161%EDch%20z%E1kon%u016F%20-%20EU
56224,22,1342130400,90,87,2,6,185,R,Vl.n.z.o%20zm%u011Bn%u011B%20da%u0148ov%FDch%2C%20pojistn%FDch%20a%20dal%u0161%EDch%20z%E1kon%u016F%20-%20EU
56225,22,1342130400,112,6,32,35,185,A,Vl.n.z.o%20zm%u011Bn%u011B%20da%u0148ov%FDch%2C%20pojistn%FDch%20a%20dal%u0161%EDch%20z%E1kon%u016F%20-%20EU
56226,22,1342130400,3,42,130,10,185,R,Vl.n.z.o%20zm%u011Bn%u011B%20da%u0148ov%FDch%2C%20pojistn%FDch%20a%20dal%u0161%EDch%20z%E1kon%u016F%20-%20EU
56227,22,1342130400,46,101,29,9,185,R,Vl.n.z.o%20zm%u011Bn%u011B%20da%u0148ov%FDch%2C%20pojistn%FDch%20a%20dal%u0161%EDch%20z%E1kon%u016F%20-%20EU
56228,22,1342130400,92,64,26,3,185,R,Vl.n.z.o%20zm%u011Bn%u011B%20da%u0148ov%FDch%2C%20pojistn%FDch%20a%20dal%u0161%EDch%20z%E1kon%u016F%20-%20EU
56229,22,1342130400,128,26,18,13,185,A,Vl.n.z.o%20zm%u011Bn%u011B%20da%u0148ov%FDch%2C%20pojistn%FDch%20a%20dal%u0161%EDch%20z%E1kon%u016F%20-%20EU
56230,22,1342130400,95,65,23,2,185,A,Vl.n.z.o%20zm%u011Bn%u011B%20da%u0148ov%FDch%2C%20pojistn%FDch%20a%20dal%u0161%EDch%20z%E1kon%u016F%20-%20EU
56231,22,1342130400,95,90,0,0,185,A,Vl.n.z.o%20zm%u011Bn%u011B%20da%u0148ov%FDch%2C%20pojistn%FDch%20a%20dal%u0161%EDch%20z%E1kon%u016F%20-%20EU
56232,15,1342130400,129,0,56,1,186,A,Rozh.Rady%20-%20r%E1mec%20pro%20Agenturu%20EU%20pro%20z%E1kl.pr%E1va%202013-2017
56233,0,1342130400,109,2,17,0,128,A,%20
56234,0,1342130400,85,69,5,0,159,A,Po%u0159ad%20sch%u016Fze
56235,21,1342130400,168,3,4,3,178,A,Novela%20z.%20o%20rozpo%u010Dtov%E9m%20ur%u010Den%ED%20dan%ED
56236,21,1342130400,143,12,19,6,180,A,Novela%20z.%20o%20rozpo%u010Dtov%E9m%20ur%u010Den%ED%20dan%ED
56237,21,1342130400,158,14,6,2,180,A,Novela%20z.%20o%20rozpo%u010Dtov%E9m%20ur%u010Den%ED%20dan%ED
56238,0,1342130400,4,1,161,0,166,R,%20
56239,0,1342130400,93,88,1,0,182,A,%20
56240,26,1342130400,35,137,7,3,182,R,Novela%20z.%20-%20%DAstava%20%u010Cesk%E9%20republiky
56241,26,1342130400,35,111,11,25,182,R,Novela%20z.%20-%20%DAstava%20%u010Cesk%E9%20republiky
56242,26,1342130400,175,1,4,2,182,A,Novela%20z.%20-%20%DAstava%20%u010Cesk%E9%20republiky
56243,26,1342130400,177,0,4,1,182,A,Novela%20z.%20-%20%DAstava%20%u010Cesk%E9%20republiky
56244,26,1342130400,90,79,4,3,176,A,Novela%20z.%20-%20%DAstava%20%u010Cesk%E9%20republiky
56245,0,1342130400,91,77,1,0,169,A,%20
56246,20,1342130400,84,88,0,0,172,R,Vl.n.z.%20o%20majetkov%E9m%20vyrovn%E1n%ED%20s%20c%EDrkvemi%20a%20n%E1bo%u017Een.%20spole%u010D.
56247,20,1342130400,78,79,9,7,173,R,Vl.n.z.%20o%20majetkov%E9m%20vyrovn%E1n%ED%20s%20c%EDrkvemi%20a%20n%E1bo%u017Een.%20spole%u010D.
56248,20,1342130400,81,90,2,0,173,R,Vl.n.z.%20o%20majetkov%E9m%20vyrovn%E1n%ED%20s%20c%EDrkvemi%20a%20n%E1bo%u017Een.%20spole%u010D.
56249,20,1342130400,84,91,5,0,180,R,Vl.n.z.%20o%20majetkov%E9m%20vyrovn%E1n%ED%20s%20c%EDrkvemi%20a%20n%E1bo%u017Een.%20spole%u010D.
56250,20,1342130400,77,80,1,0,158,R,Vl.n.z.%20o%20majetkov%E9m%20vyrovn%E1n%ED%20s%20c%EDrkvemi%20a%20n%E1bo%u017Een.%20spole%u010D.
56251,20,1342130400,66,80,10,6,162,R,Vl.n.z.%20o%20majetkov%E9m%20vyrovn%E1n%ED%20s%20c%EDrkvemi%20a%20n%E1bo%u017Een.%20spole%u010D.
56252,20,1342130400,79,84,1,0,164,R,Vl.n.z.%20o%20majetkov%E9m%20vyrovn%E1n%ED%20s%20c%EDrkvemi%20a%20n%E1bo%u017Een.%20spole%u010D.
56253,20,1342130400,86,85,5,0,176,R,Vl.n.z.%20o%20majetkov%E9m%20vyrovn%E1n%ED%20s%20c%EDrkvemi%20a%20n%E1bo%u017Een.%20spole%u010D.
56254,20,1342130400,76,70,26,4,176,R,Vl.n.z.%20o%20majetkov%E9m%20vyrovn%E1n%ED%20s%20c%EDrkvemi%20a%20n%E1bo%u017Een.%20spole%u010D.
56255,20,1342130400,83,86,6,1,176,R,Vl.n.z.%20o%20majetkov%E9m%20vyrovn%E1n%ED%20s%20c%EDrkvemi%20a%20n%E1bo%u017Een.%20spole%u010D.
56256,20,1342130400,87,88,2,0,177,R,Vl.n.z.%20o%20majetkov%E9m%20vyrovn%E1n%ED%20s%20c%EDrkvemi%20a%20n%E1bo%u017Een.%20spole%u010D.
56257,20,1342130400,159,6,9,3,177,A,Vl.n.z.%20o%20majetkov%E9m%20vyrovn%E1n%ED%20s%20c%EDrkvemi%20a%20n%E1bo%u017Een.%20spole%u010D.
56258,20,1342130400,88,90,0,0,178,R,Vl.n.z.%20o%20majetkov%E9m%20vyrovn%E1n%ED%20s%20c%EDrkvemi%20a%20n%E1bo%u017Een.%20spole%u010D.
56259,20,1342130400,82,82,11,4,179,R,Vl.n.z.%20o%20majetkov%E9m%20vyrovn%E1n%ED%20s%20c%EDrkvemi%20a%20n%E1bo%u017Een.%20spole%u010D.
56260,20,1342130400,86,90,2,1,179,R,Vl.n.z.%20o%20majetkov%E9m%20vyrovn%E1n%ED%20s%20c%EDrkvemi%20a%20n%E1bo%u017Een.%20spole%u010D.
56261,20,1342130400,87,89,1,0,177,R,Vl.n.z.%20o%20majetkov%E9m%20vyrovn%E1n%ED%20s%20c%EDrkvemi%20a%20n%E1bo%u017Een.%20spole%u010D.
56262,20,1342130400,88,79,7,6,180,R,Vl.n.z.%20o%20majetkov%E9m%20vyrovn%E1n%ED%20s%20c%EDrkvemi%20a%20n%E1bo%u017Een.%20spole%u010D.
56263,20,1342130400,87,92,1,0,180,R,Vl.n.z.%20o%20majetkov%E9m%20vyrovn%E1n%ED%20s%20c%EDrkvemi%20a%20n%E1bo%u017Een.%20spole%u010D.
56264,20,1342130400,80,94,1,1,176,R,Vl.n.z.%20o%20majetkov%E9m%20vyrovn%E1n%ED%20s%20c%EDrkvemi%20a%20n%E1bo%u017Een.%20spole%u010D.
56265,20,1342130400,85,76,5,7,173,R,Vl.n.z.%20o%20majetkov%E9m%20vyrovn%E1n%ED%20s%20c%EDrkvemi%20a%20n%E1bo%u017Een.%20spole%u010D.
56266,20,1342130400,83,92,0,0,175,R,Vl.n.z.%20o%20majetkov%E9m%20vyrovn%E1n%ED%20s%20c%EDrkvemi%20a%20n%E1bo%u017Een.%20spole%u010D.
56267,20,1342130400,42,103,6,7,158,R,Vl.n.z.%20o%20majetkov%E9m%20vyrovn%E1n%ED%20s%20c%EDrkvemi%20a%20n%E1bo%u017Een.%20spole%u010D.
56268,20,1342130400,77,84,0,0,161,R,Vl.n.z.%20o%20majetkov%E9m%20vyrovn%E1n%ED%20s%20c%EDrkvemi%20a%20n%E1bo%u017Een.%20spole%u010D.
56269,20,1342130400,35,126,6,6,173,R,Vl.n.z.%20o%20majetkov%E9m%20vyrovn%E1n%ED%20s%20c%EDrkvemi%20a%20n%E1bo%u017Een.%20spole%u010D.
56270,20,1342130400,86,89,0,0,175,R,Vl.n.z.%20o%20majetkov%E9m%20vyrovn%E1n%ED%20s%20c%EDrkvemi%20a%20n%E1bo%u017Een.%20spole%u010D.
56271,20,1342130400,21,130,19,10,180,R,Vl.n.z.%20o%20majetkov%E9m%20vyrovn%E1n%ED%20s%20c%EDrkvemi%20a%20n%E1bo%u017Een.%20spole%u010D.
56272,20,1342130400,90,90,1,0,181,R,Vl.n.z.%20o%20majetkov%E9m%20vyrovn%E1n%ED%20s%20c%EDrkvemi%20a%20n%E1bo%u017Een.%20spole%u010D.
56273,20,1342130400,174,5,1,1,181,A,Vl.n.z.%20o%20majetkov%E9m%20vyrovn%E1n%ED%20s%20c%EDrkvemi%20a%20n%E1bo%u017Een.%20spole%u010D.
56274,20,1342130400,89,92,0,1,182,R,Vl.n.z.%20o%20majetkov%E9m%20vyrovn%E1n%ED%20s%20c%EDrkvemi%20a%20n%E1bo%u017Een.%20spole%u010D.
56275,20,1342130400,89,92,0,1,182,R,Vl.n.z.%20o%20majetkov%E9m%20vyrovn%E1n%ED%20s%20c%EDrkvemi%20a%20n%E1bo%u017Een.%20spole%u010D.
56276,20,1342130400,178,3,0,1,182,A,Vl.n.z.%20o%20majetkov%E9m%20vyrovn%E1n%ED%20s%20c%EDrkvemi%20a%20n%E1bo%u017Een.%20spole%u010D.
56277,20,1342130400,90,90,2,0,182,R,Vl.n.z.%20o%20majetkov%E9m%20vyrovn%E1n%ED%20s%20c%EDrkvemi%20a%20n%E1bo%u017Een.%20spole%u010D.
56278,20,1342130400,89,92,1,0,182,R,Vl.n.z.%20o%20majetkov%E9m%20vyrovn%E1n%ED%20s%20c%EDrkvemi%20a%20n%E1bo%u017Een.%20spole%u010D.
56279,20,1342130400,89,92,1,0,182,R,Vl.n.z.%20o%20majetkov%E9m%20vyrovn%E1n%ED%20s%20c%EDrkvemi%20a%20n%E1bo%u017Een.%20spole%u010D.
56280,20,1342130400,179,3,0,0,182,A,Vl.n.z.%20o%20majetkov%E9m%20vyrovn%E1n%ED%20s%20c%EDrkvemi%20a%20n%E1bo%u017Een.%20spole%u010D.
56281,20,1342130400,99,20,56,7,182,A,Vl.n.z.%20o%20majetkov%E9m%20vyrovn%E1n%ED%20s%20c%EDrkvemi%20a%20n%E1bo%u017Een.%20spole%u010D.
56282,20,1342130400,11,34,101,35,181,R,Vl.n.z.%20o%20majetkov%E9m%20vyrovn%E1n%ED%20s%20c%EDrkvemi%20a%20n%E1bo%u017Een.%20spole%u010D.
56283,20,1342130400,88,19,53,22,182,R,Vl.n.z.%20o%20majetkov%E9m%20vyrovn%E1n%ED%20s%20c%EDrkvemi%20a%20n%E1bo%u017Een.%20spole%u010D.
56284,20,1342130400,101,52,24,5,182,A,Vl.n.z.%20o%20majetkov%E9m%20vyrovn%E1n%ED%20s%20c%EDrkvemi%20a%20n%E1bo%u017Een.%20spole%u010D.
56285,20,1342130400,14,100,38,30,182,R,Vl.n.z.%20o%20majetkov%E9m%20vyrovn%E1n%ED%20s%20c%EDrkvemi%20a%20n%E1bo%u017Een.%20spole%u010D.
56286,20,1342130400,100,28,45,9,182,A,Vl.n.z.%20o%20majetkov%E9m%20vyrovn%E1n%ED%20s%20c%EDrkvemi%20a%20n%E1bo%u017Een.%20spole%u010D.
56287,20,1342130400,10,38,103,31,182,R,Vl.n.z.%20o%20majetkov%E9m%20vyrovn%E1n%ED%20s%20c%EDrkvemi%20a%20n%E1bo%u017Een.%20spole%u010D.
56288,20,1342130400,84,22,55,21,182,R,Vl.n.z.%20o%20majetkov%E9m%20vyrovn%E1n%ED%20s%20c%EDrkvemi%20a%20n%E1bo%u017Een.%20spole%u010D.
56289,20,1342130400,103,41,24,14,182,A,Vl.n.z.%20o%20majetkov%E9m%20vyrovn%E1n%ED%20s%20c%EDrkvemi%20a%20n%E1bo%u017Een.%20spole%u010D.
56290,20,1342130400,88,92,1,1,182,R,Vl.n.z.%20o%20majetkov%E9m%20vyrovn%E1n%ED%20s%20c%EDrkvemi%20a%20n%E1bo%u017Een.%20spole%u010D.
56291,20,1342130400,145,4,27,6,182,A,Vl.n.z.%20o%20majetkov%E9m%20vyrovn%E1n%ED%20s%20c%EDrkvemi%20a%20n%E1bo%u017Een.%20spole%u010D.
56292,20,1342130400,16,102,32,32,182,R,Vl.n.z.%20o%20majetkov%E9m%20vyrovn%E1n%ED%20s%20c%EDrkvemi%20a%20n%E1bo%u017Een.%20spole%u010D.
56293,20,1342130400,171,3,3,5,182,A,Vl.n.z.%20o%20majetkov%E9m%20vyrovn%E1n%ED%20s%20c%EDrkvemi%20a%20n%E1bo%u017Een.%20spole%u010D.
56294,20,1342130400,17,101,34,30,182,R,Vl.n.z.%20o%20majetkov%E9m%20vyrovn%E1n%ED%20s%20c%EDrkvemi%20a%20n%E1bo%u017Een.%20spole%u010D.
56295,20,1342130400,86,92,2,2,182,R,Vl.n.z.%20o%20majetkov%E9m%20vyrovn%E1n%ED%20s%20c%EDrkvemi%20a%20n%E1bo%u017Een.%20spole%u010D.
56296,20,1342130400,83,90,6,3,182,R,Vl.n.z.%20o%20majetkov%E9m%20vyrovn%E1n%ED%20s%20c%EDrkvemi%20a%20n%E1bo%u017Een.%20spole%u010D.
56297,20,1342130400,87,90,5,0,182,R,Vl.n.z.%20o%20majetkov%E9m%20vyrovn%E1n%ED%20s%20c%EDrkvemi%20a%20n%E1bo%u017Een.%20spole%u010D.
56298,20,1342130400,88,90,4,0,182,R,Vl.n.z.%20o%20majetkov%E9m%20vyrovn%E1n%ED%20s%20c%EDrkvemi%20a%20n%E1bo%u017Een.%20spole%u010D.
56299,20,1342130400,87,89,3,3,182,R,Vl.n.z.%20o%20majetkov%E9m%20vyrovn%E1n%ED%20s%20c%EDrkvemi%20a%20n%E1bo%u017Een.%20spole%u010D.
56300,20,1342130400,88,84,9,1,182,R,Vl.n.z.%20o%20majetkov%E9m%20vyrovn%E1n%ED%20s%20c%EDrkvemi%20a%20n%E1bo%u017Een.%20spole%u010D.
56301,20,1342130400,81,99,2,0,182,R,Vl.n.z.%20o%20majetkov%E9m%20vyrovn%E1n%ED%20s%20c%EDrkvemi%20a%20n%E1bo%u017Een.%20spole%u010D.
56302,20,1342130400,88,92,2,0,182,R,Vl.n.z.%20o%20majetkov%E9m%20vyrovn%E1n%ED%20s%20c%EDrkvemi%20a%20n%E1bo%u017Een.%20spole%u010D.
56303,20,1342130400,164,9,4,5,182,A,Vl.n.z.%20o%20majetkov%E9m%20vyrovn%E1n%ED%20s%20c%EDrkvemi%20a%20n%E1bo%u017Een.%20spole%u010D.
56304,20,1342130400,88,92,1,1,182,R,Vl.n.z.%20o%20majetkov%E9m%20vyrovn%E1n%ED%20s%20c%EDrkvemi%20a%20n%E1bo%u017Een.%20spole%u010D.
56305,20,1342130400,78,100,3,1,182,R,Vl.n.z.%20o%20majetkov%E9m%20vyrovn%E1n%ED%20s%20c%EDrkvemi%20a%20n%E1bo%u017Een.%20spole%u010D.
56306,20,1342130400,88,91,3,0,182,R,Vl.n.z.%20o%20majetkov%E9m%20vyrovn%E1n%ED%20s%20c%EDrkvemi%20a%20n%E1bo%u017Een.%20spole%u010D.
56307,20,1342130400,88,90,3,1,182,R,Vl.n.z.%20o%20majetkov%E9m%20vyrovn%E1n%ED%20s%20c%EDrkvemi%20a%20n%E1bo%u017Een.%20spole%u010D.
56308,20,1342130400,89,91,2,0,182,R,Vl.n.z.%20o%20majetkov%E9m%20vyrovn%E1n%ED%20s%20c%EDrkvemi%20a%20n%E1bo%u017Een.%20spole%u010D.
56309,20,1342130400,88,93,1,0,182,R,Vl.n.z.%20o%20majetkov%E9m%20vyrovn%E1n%ED%20s%20c%EDrkvemi%20a%20n%E1bo%u017Een.%20spole%u010D.
56310,20,1342130400,79,103,0,0,182,R,Vl.n.z.%20o%20majetkov%E9m%20vyrovn%E1n%ED%20s%20c%EDrkvemi%20a%20n%E1bo%u017Een.%20spole%u010D.
56311,20,1342130400,79,99,4,0,182,R,Vl.n.z.%20o%20majetkov%E9m%20vyrovn%E1n%ED%20s%20c%EDrkvemi%20a%20n%E1bo%u017Een.%20spole%u010D.
56312,20,1342130400,88,91,3,0,182,R,Vl.n.z.%20o%20majetkov%E9m%20vyrovn%E1n%ED%20s%20c%EDrkvemi%20a%20n%E1bo%u017Een.%20spole%u010D.
56313,20,1342130400,89,89,4,0,182,R,Vl.n.z.%20o%20majetkov%E9m%20vyrovn%E1n%ED%20s%20c%EDrkvemi%20a%20n%E1bo%u017Een.%20spole%u010D.
56314,20,1342130400,87,92,2,1,182,R,Vl.n.z.%20o%20majetkov%E9m%20vyrovn%E1n%ED%20s%20c%EDrkvemi%20a%20n%E1bo%u017Een.%20spole%u010D.
56315,20,1342130400,89,92,1,0,182,R,Vl.n.z.%20o%20majetkov%E9m%20vyrovn%E1n%ED%20s%20c%EDrkvemi%20a%20n%E1bo%u017Een.%20spole%u010D.
56316,20,1342130400,88,92,1,1,182,R,Vl.n.z.%20o%20majetkov%E9m%20vyrovn%E1n%ED%20s%20c%EDrkvemi%20a%20n%E1bo%u017Een.%20spole%u010D.
56317,20,1342130400,89,92,1,0,182,R,Vl.n.z.%20o%20majetkov%E9m%20vyrovn%E1n%ED%20s%20c%EDrkvemi%20a%20n%E1bo%u017Een.%20spole%u010D.
56318,20,1342130400,77,102,3,0,182,R,Vl.n.z.%20o%20majetkov%E9m%20vyrovn%E1n%ED%20s%20c%EDrkvemi%20a%20n%E1bo%u017Een.%20spole%u010D.
56319,20,1342130400,78,99,4,1,182,R,Vl.n.z.%20o%20majetkov%E9m%20vyrovn%E1n%ED%20s%20c%EDrkvemi%20a%20n%E1bo%u017Een.%20spole%u010D.
56320,20,1342130400,79,102,1,0,182,R,Vl.n.z.%20o%20majetkov%E9m%20vyrovn%E1n%ED%20s%20c%EDrkvemi%20a%20n%E1bo%u017Een.%20spole%u010D.
56321,20,1342130400,89,89,0,4,182,R,Vl.n.z.%20o%20majetkov%E9m%20vyrovn%E1n%ED%20s%20c%EDrkvemi%20a%20n%E1bo%u017Een.%20spole%u010D.
56322,20,1342130400,93,89,0,0,182,A,Vl.n.z.%20o%20majetkov%E9m%20vyrovn%E1n%ED%20s%20c%EDrkvemi%20a%20n%E1bo%u017Een.%20spole%u010D.
56323,20,1342130400,176,1,1,3,181,A,Vl.n.z.%20o%20majetkov%E9m%20vyrovn%E1n%ED%20s%20c%EDrkvemi%20a%20n%E1bo%u017Een.%20spole%u010D.
56324,20,1342130400,93,88,1,0,182,A,Vl.n.z.%20o%20majetkov%E9m%20vyrovn%E1n%ED%20s%20c%EDrkvemi%20a%20n%E1bo%u017Een.%20spole%u010D.
56325,20,1342216800,163,11,4,4,182,A,Vl.n.z.%20o%20majetkov%E9m%20vyrovn%E1n%ED%20s%20c%EDrkvemi%20a%20n%E1bo%u017Een.%20spole%u010D.
56326,20,1342216800,93,89,0,0,182,A,Vl.n.z.%20o%20majetkov%E9m%20vyrovn%E1n%ED%20s%20c%EDrkvemi%20a%20n%E1bo%u017Een.%20spole%u010D.
56327,0,1342216800,115,55,5,1,176,A,%20
56328,3,1342562400,79,91,2,1,173,R,Vl.n.z.%20o%20pojistn%E9m%20na%20d%u016Fchodov%E9%20spo%u0159en%ED%20-%20EU
56329,3,1342562400,92,78,2,1,173,A,Vl.n.z.%20o%20pojistn%E9m%20na%20d%u016Fchodov%E9%20spo%u0159en%ED%20-%20EU
56330,3,1342562400,170,2,3,0,175,A,Vl.n.z.%20o%20pojistn%E9m%20na%20d%u016Fchodov%E9%20spo%u0159en%ED%20-%20EU
56331,3,1342562400,94,79,1,1,175,A,Vl.n.z.%20o%20pojistn%E9m%20na%20d%u016Fchodov%E9%20spo%u0159en%ED%20-%20EU
56332,4,1342562400,78,96,3,1,178,R,Vl.n.z.o%20pojistn%E9m%20na%20d%u016Fchodov%E9%20spo%u0159en%ED%20-%20souvisej%EDc%ED%20-%20EU
56333,4,1342562400,6,4,168,0,178,R,Vl.n.z.o%20pojistn%E9m%20na%20d%u016Fchodov%E9%20spo%u0159en%ED%20-%20souvisej%EDc%ED%20-%20EU
56334,4,1342562400,102,76,0,1,179,A,Vl.n.z.o%20pojistn%E9m%20na%20d%u016Fchodov%E9%20spo%u0159en%ED%20-%20souvisej%EDc%ED%20-%20EU
56335,4,1342562400,101,76,1,1,179,A,Vl.n.z.o%20pojistn%E9m%20na%20d%u016Fchodov%E9%20spo%u0159en%ED%20-%20souvisej%EDc%ED%20-%20EU
56336,4,1342562400,152,4,22,1,179,A,Vl.n.z.o%20pojistn%E9m%20na%20d%u016Fchodov%E9%20spo%u0159en%ED%20-%20souvisej%EDc%ED%20-%20EU
56337,4,1342562400,98,79,1,1,179,A,Vl.n.z.o%20pojistn%E9m%20na%20d%u016Fchodov%E9%20spo%u0159en%ED%20-%20souvisej%EDc%ED%20-%20EU
56338,0,1342562400,133,0,13,0,146,A,%20
56339,0,1342562400,88,89,0,1,178,R,Po%u0159ad%20sch%u016Fze
56340,0,1342562400,120,0,10,0,130,A,%20
56341,1,1342562400,79,5,2,1,87,A,N%E1vrh%20na%20vysloven%ED%20ned%u016Fv%u011Bry%20vl%E1d%u011B%20%u010Cesk%E9%20republiky
56342,1,1342562400,89,89,0,0,178,R,N%E1vrh%20na%20vysloven%ED%20ned%u016Fv%u011Bry%20vl%E1d%u011B%20%u010Cesk%E9%20republiky
56343,0,1346709600,156,0,17,1,174,A,%20
56344,0,1346796000,82,95,0,0,177,R,Po%u0159ad%20sch%u016Fze
56345,0,1346796000,150,27,2,4,183,A,Po%u0159ad%20sch%u016Fze
56346,0,1346796000,182,0,3,0,185,A,Po%u0159ad%20sch%u016Fze
56347,0,1346796000,180,1,4,1,186,A,Po%u0159ad%20sch%u016Fze
56348,0,1346796000,87,98,2,1,188,R,Po%u0159ad%20sch%u016Fze
56349,0,1346796000,88,96,2,2,188,R,Po%u0159ad%20sch%u016Fze
56350,0,1346796000,87,92,6,4,189,R,Po%u0159ad%20sch%u016Fze
56351,0,1346796000,102,81,2,5,190,A,Po%u0159ad%20sch%u016Fze
56352,0,1346796000,50,97,29,14,190,R,Po%u0159ad%20sch%u016Fze
56353,0,1346796000,84,94,7,5,190,R,Po%u0159ad%20sch%u016Fze
56354,0,1346796000,84,93,8,5,190,R,Po%u0159ad%20sch%u016Fze
56355,0,1346796000,51,105,8,27,191,R,Po%u0159ad%20sch%u016Fze
56356,0,1346796000,89,96,4,2,191,R,Po%u0159ad%20sch%u016Fze
56357,0,1346796000,62,102,13,15,192,R,Po%u0159ad%20sch%u016Fze
56358,0,1346796000,90,90,10,2,192,R,Po%u0159ad%20sch%u016Fze
56359,0,1346796000,45,107,12,28,192,R,Po%u0159ad%20sch%u016Fze
56360,0,1346796000,30,111,30,22,193,R,Po%u0159ad%20sch%u016Fze
56361,0,1346796000,81,97,12,3,193,R,Po%u0159ad%20sch%u016Fze
56362,0,1346796000,50,108,12,23,193,R,Po%u0159ad%20sch%u016Fze
56363,0,1346796000,89,70,9,25,193,R,Po%u0159ad%20sch%u016Fze
56364,0,1346796000,86,97,8,2,193,R,Po%u0159ad%20sch%u016Fze
56365,0,1346796000,87,93,10,3,193,R,Po%u0159ad%20sch%u016Fze
56366,0,1346796000,84,101,5,3,193,R,Po%u0159ad%20sch%u016Fze
56367,0,1346796000,72,92,13,16,193,R,Po%u0159ad%20sch%u016Fze
56368,0,1346796000,81,99,11,2,193,R,Po%u0159ad%20sch%u016Fze
56369,0,1346796000,84,101,4,4,193,R,Po%u0159ad%20sch%u016Fze
56370,0,1346796000,67,101,11,14,193,R,Po%u0159ad%20sch%u016Fze
56371,0,1346796000,81,94,14,4,193,R,Po%u0159ad%20sch%u016Fze
56372,0,1346796000,86,92,10,5,193,R,Po%u0159ad%20sch%u016Fze
56373,0,1346796000,81,97,10,5,193,R,Po%u0159ad%20sch%u016Fze
56374,0,1346796000,185,3,3,4,195,A,Po%u0159ad%20sch%u016Fze
56375,0,1346796000,182,5,5,3,195,A,Po%u0159ad%20sch%u016Fze
56376,0,1346796000,107,87,0,1,195,A,Po%u0159ad%20sch%u016Fze
56377,0,1346796000,160,2,33,2,197,A,%20
56378,3,1346796000,90,99,2,2,193,R,Novela%20z.%20o%20d%u016Fchodov%E9m%20poji%u0161t%u011Bn%ED
56379,3,1346796000,101,92,0,0,193,A,Novela%20z.%20o%20d%u016Fchodov%E9m%20poji%u0161t%u011Bn%ED
56380,4,1346796000,56,18,120,0,194,R,Vl.n.z.o%20zm%u011Bn%u011B%20da%u0148ov%FDch%2C%20pojistn%FDch%20a%20dal%u0161%EDch%20z%E1kon%u016F%20-%20EU
56381,4,1346796000,119,44,17,12,192,A,Vl.n.z.o%20zm%u011Bn%u011B%20da%u0148ov%FDch%2C%20pojistn%FDch%20a%20dal%u0161%EDch%20z%E1kon%u016F%20-%20EU
56382,4,1346796000,94,101,1,0,196,R,Vl.n.z.o%20zm%u011Bn%u011B%20da%u0148ov%FDch%2C%20pojistn%FDch%20a%20dal%u0161%EDch%20z%E1kon%u016F%20-%20EU
56383,5,1346796000,108,59,24,7,198,A,Novela%20z.%20o%20soci%E1ln%u011B-pr%E1vn%ED%20ochran%u011B%20d%u011Bt%ED
56384,20,1346882400,62,4,6,2,74,A,P%EDsemn%E1%20interpelace%20B.%20Petra%20na%20M.%20Kubu%20ve%20v%u011Bci%20zpracov%E1n%ED%20st%E1tn%ED%20ener
56385,20,1346882400,58,9,8,1,76,A,P%EDsemn%E1%20interpelace%20M.%20Greben%ED%u010Dka%20na%20P.%20Ne%u010Dase%20ve%20v%u011Bci%20podez%u0159en%ED%20vl%E1dy
56387,20,1346882400,69,7,7,0,83,A,Odpov%u011Bdi%20%u010Dlen%u016F%20vl%E1dy%20na%20p%EDsemn%E9%20interpelace
56388,20,1346882400,62,8,7,1,78,A,P%EDsemn%E1%20interpelace%20J.%20Tanco%u0161e%20na%20L.%20Hegera%20ve%20v%u011Bci%20ve%20v%u011Bci%20zachov%E1n%ED
56389,20,1346882400,61,11,6,0,78,A,P%EDsemn%E1%20interpelace%20M.%20V%E1ni%20na%20P.%20Ne%u010Dase%20ve%20v%u011Bci%20v%20jak%E9m%20stavu%20je%20na%u0161
56390,20,1346882400,67,4,8,0,79,A,P%EDsemn%E1%20interpelace%20K.%20Kone%u010Dn%E9%20na%20T.%20Chalupu%20ve%20v%u011Bci%20postupu%20Odboru%20oc
56391,20,1346882400,61,6,11,2,80,A,Odpov%u011Bdi%20%u010Dlen%u016F%20vl%E1dy%20na%20p%EDsemn%E9%20interpelace
56392,6,1346882400,102,64,6,4,176,A,Novela%20z.%20-%20trestn%ED%20z%E1kon%EDk
56394,0,1346968800,146,0,8,7,161,A,%20
56395,19,1346968800,73,33,36,29,171,R,%u017D%E1dost%20o%20vysloven%ED%20souhlasu%20k%20trestn%EDmu%20st%EDh%E1n%ED%20D.%20Ratha
56396,19,1346968800,174,4,3,4,185,A,%u017D%E1dost%20o%20vysloven%ED%20souhlasu%20k%20trestn%EDmu%20st%EDh%E1n%ED%20D.%20Ratha
56397,19,1346968800,6,69,62,50,187,R,%u017D%E1dost%20o%20vysloven%ED%20souhlasu%20k%20trestn%EDmu%20st%EDh%E1n%ED%20D.%20Ratha
56398,19,1346968800,80,39,37,30,186,R,%u017D%E1dost%20o%20vysloven%ED%20souhlasu%20k%20trestn%EDmu%20st%EDh%E1n%ED%20D.%20Ratha
56399,7,1346968800,103,80,0,1,184,A,Vl.n.z.%20o%20pojistn%E9m%20na%20d%u016Fchodov%E9%20spo%u0159en%ED%20-%20EU
56400,8,1346968800,102,78,1,1,182,A,Vl.n.z.o%20pojistn%E9m%20na%20d%u016Fchodov%E9%20spo%u0159en%ED%20-%20souvisej%EDc%ED%20-%20EU
56401,0,1346968800,138,21,20,4,183,A,%20
56402,0,1347919200,136,3,12,0,151,A,%20
56403,0,1347919200,56,40,89,2,187,R,Po%u0159ad%20sch%u016Fze
56404,0,1347919200,85,82,5,3,175,R,Po%u0159ad%20sch%u016Fze
56405,0,1347919200,106,44,23,9,182,A,Po%u0159ad%20sch%u016Fze
56406,0,1347919200,95,86,0,3,184,A,Po%u0159ad%20sch%u016Fze
56407,0,1347919200,179,3,3,0,185,A,Po%u0159ad%20sch%u016Fze
56408,0,1347919200,182,3,0,0,185,A,Po%u0159ad%20sch%u016Fze
56409,0,1347919200,89,96,0,1,186,R,Po%u0159ad%20sch%u016Fze
56410,0,1347919200,98,85,0,3,186,A,Po%u0159ad%20sch%u016Fze
56411,0,1347919200,87,84,7,8,186,R,Po%u0159ad%20sch%u016Fze
56412,0,1347919200,183,1,2,0,186,A,Po%u0159ad%20sch%u016Fze
56413,0,1347919200,148,5,30,3,186,A,Po%u0159ad%20sch%u016Fze
56414,0,1347919200,85,82,16,4,187,R,Po%u0159ad%20sch%u016Fze
56415,0,1347919200,82,84,13,7,186,R,Po%u0159ad%20sch%u016Fze
56416,0,1347919200,95,79,9,3,186,A,Po%u0159ad%20sch%u016Fze
56417,0,1347919200,120,39,18,9,186,A,Po%u0159ad%20sch%u016Fze
56418,0,1347919200,91,79,9,7,186,R,Po%u0159ad%20sch%u016Fze
56419,0,1347919200,57,79,45,5,186,R,Po%u0159ad%20sch%u016Fze
56420,0,1347919200,70,96,14,6,186,R,Po%u0159ad%20sch%u016Fze
56421,0,1347919200,41,133,6,6,186,R,Po%u0159ad%20sch%u016Fze
56422,0,1347919200,87,93,4,2,186,R,Po%u0159ad%20sch%u016Fze
56423,0,1347919200,100,68,11,7,186,A,Po%u0159ad%20sch%u016Fze
56424,0,1347919200,97,53,29,7,186,A,Po%u0159ad%20sch%u016Fze
56425,0,1347919200,85,80,15,6,186,R,Po%u0159ad%20sch%u016Fze
56426,0,1347919200,89,90,3,4,186,R,Po%u0159ad%20sch%u016Fze
56427,0,1347919200,89,68,15,14,186,R,Po%u0159ad%20sch%u016Fze
56428,0,1347919200,89,86,6,5,186,R,Po%u0159ad%20sch%u016Fze
56429,0,1347919200,78,97,7,4,186,R,Po%u0159ad%20sch%u016Fze
56430,0,1347919200,85,90,7,4,186,R,Po%u0159ad%20sch%u016Fze
56431,0,1347919200,68,105,9,4,186,R,Po%u0159ad%20sch%u016Fze
56432,0,1347919200,89,71,18,8,186,R,Po%u0159ad%20sch%u016Fze
56433,0,1347919200,90,73,13,10,186,R,Po%u0159ad%20sch%u016Fze
56434,0,1347919200,84,93,6,3,186,R,Po%u0159ad%20sch%u016Fze
56435,0,1347919200,163,4,5,14,186,A,Po%u0159ad%20sch%u016Fze
56436,0,1347919200,177,2,6,1,186,A,Po%u0159ad%20sch%u016Fze
56437,0,1347919200,177,3,3,3,186,A,Po%u0159ad%20sch%u016Fze
56438,0,1347919200,85,80,13,8,186,R,Po%u0159ad%20sch%u016Fze
56439,0,1347919200,151,25,3,7,186,A,Po%u0159ad%20sch%u016Fze
56440,0,1347919200,175,6,4,1,186,A,Po%u0159ad%20sch%u016Fze
56441,0,1347919200,83,95,5,3,186,R,Po%u0159ad%20sch%u016Fze
56442,0,1347919200,52,95,34,5,186,R,Po%u0159ad%20sch%u016Fze
56443,0,1347919200,82,91,9,4,186,R,Po%u0159ad%20sch%u016Fze
56444,0,1347919200,99,85,0,2,186,A,Po%u0159ad%20sch%u016Fze
56445,1,1347919200,91,47,17,3,158,A,Vl.n.z.%20o%20zm%u011Bn%u011B%20da%u0148ov%FDch%2C%20pojistn%FDch%20a%20dal%u0161%EDch%20z%E1kon%u016F%20-%20EU
56446,1,1347919200,152,4,6,0,162,A,Vl.n.z.%20o%20zm%u011Bn%u011B%20da%u0148ov%FDch%2C%20pojistn%FDch%20a%20dal%u0161%EDch%20z%E1kon%u016F%20-%20EU
56447,1,1347919200,96,52,16,3,167,A,Vl.n.z.%20o%20zm%u011Bn%u011B%20da%u0148ov%FDch%2C%20pojistn%FDch%20a%20dal%u0161%EDch%20z%E1kon%u016F%20-%20EU
56448,1,1347919200,15,125,13,10,163,R,Vl.n.z.%20o%20zm%u011Bn%u011B%20da%u0148ov%FDch%2C%20pojistn%FDch%20a%20dal%u0161%EDch%20z%E1kon%u016F%20-%20EU
56449,1,1347919200,77,87,0,1,165,R,Vl.n.z.%20o%20zm%u011Bn%u011B%20da%u0148ov%FDch%2C%20pojistn%FDch%20a%20dal%u0161%EDch%20z%E1kon%u016F%20-%20EU
56450,1,1347919200,84,88,3,4,179,R,Vl.n.z.%20o%20zm%u011Bn%u011B%20da%u0148ov%FDch%2C%20pojistn%FDch%20a%20dal%u0161%EDch%20z%E1kon%u016F%20-%20EU
56451,1,1347919200,84,88,3,4,179,R,Vl.n.z.%20o%20zm%u011Bn%u011B%20da%u0148ov%FDch%2C%20pojistn%FDch%20a%20dal%u0161%EDch%20z%E1kon%u016F%20-%20EU
56452,1,1347919200,174,2,3,0,179,A,Vl.n.z.%20o%20zm%u011Bn%u011B%20da%u0148ov%FDch%2C%20pojistn%FDch%20a%20dal%u0161%EDch%20z%E1kon%u016F%20-%20EU
56453,1,1347919200,95,79,3,2,179,A,Vl.n.z.%20o%20zm%u011Bn%u011B%20da%u0148ov%FDch%2C%20pojistn%FDch%20a%20dal%u0161%EDch%20z%E1kon%u016F%20-%20EU
56454,40,1347919200,127,0,22,0,149,A,Vl.n.z.%20o%20podm%EDnk%E1ch%20obch.%20s%20povol.%20na%20emise%20sklen%EDk.plyn%u016F%20-%20EU
56455,40,1347919200,53,37,17,21,128,R,Vl.n.z.%20o%20podm%EDnk%E1ch%20obch.%20s%20povol.%20na%20emise%20sklen%EDk.plyn%u016F%20-%20EU
56456,40,1347919200,108,10,9,2,129,A,Vl.n.z.%20o%20podm%EDnk%E1ch%20obch.%20s%20povol.%20na%20emise%20sklen%EDk.plyn%u016F%20-%20EU
56457,0,1348005600,139,4,4,2,149,A,Po%u0159ad%20sch%u016Fze
56458,0,1348005600,134,2,20,0,156,A,Po%u0159ad%20sch%u016Fze
56459,2,1348005600,105,43,31,9,188,A,Novela%20z.%20o%20hospoda%u0159en%ED%20energi%ED%20-%20EU
56460,3,1348005600,67,105,9,1,182,R,Novela%20z.%20-%20ob%u010Dansk%FD%20soudn%ED%20%u0159%E1d
56461,3,1348005600,105,73,6,3,187,A,Novela%20z.%20-%20ob%u010Dansk%FD%20soudn%ED%20%u0159%E1d
56462,3,1348005600,177,2,7,3,189,A,Novela%20z.%20-%20ob%u010Dansk%FD%20soudn%ED%20%u0159%E1d
56463,3,1348005600,102,77,6,3,188,A,Novela%20z.%20-%20ob%u010Dansk%FD%20soudn%ED%20%u0159%E1d
56464,4,1348005600,39,109,30,10,188,R,Novela%20z.%20o%20%FAzemn%EDm%20pl%E1nov.%20a%20staveb.%20%u0159%E1du%20%28stavebn%ED%20z%E1kon%29%20-%20EU
56465,4,1348005600,122,18,34,14,188,A,Novela%20z.%20o%20%FAzemn%EDm%20pl%E1nov.%20a%20staveb.%20%u0159%E1du%20%28stavebn%ED%20z%E1kon%29%20-%20EU
56466,5,1348005600,9,103,44,32,188,R,Novela%20z.%20o%20v%FDkonu%20%FAstavn%ED%20v%FDchovy
56467,5,1348005600,171,0,17,0,188,A,Novela%20z.%20o%20v%FDkonu%20%FAstavn%ED%20v%FDchovy
56468,6,1348005600,76,96,16,0,188,R,Novela%20z.%20na%20ochranu%20zv%ED%u0159at%20proti%20t%FDr%E1n%ED%20-%20EU
56469,6,1348005600,176,3,2,1,182,A,Novela%20z.%20na%20ochranu%20zv%ED%u0159at%20proti%20t%FDr%E1n%ED%20-%20EU
56470,7,1348005600,79,99,2,0,180,R,Novela%20z.%20o%20st%E1tn%ED%20soci%E1ln%ED%20podpo%u0159e
56471,7,1348005600,143,8,5,24,180,A,Novela%20z.%20o%20st%E1tn%ED%20soci%E1ln%ED%20podpo%u0159e
56472,8,1348005600,153,0,27,0,180,A,Novela%20z.%20-%20insolven%u010Dn%ED%20z%E1kon
56473,9,1348005600,141,0,36,1,178,A,Novela%20z.%20o%20ochran%u011B%20hospod%E1%u0159sk%E9%20sout%u011B%u017Ee
56474,149,1348092000,46,22,9,2,79,A,P%EDsemn%E1%20interpelace%20B.%20Petra%20na%20M.%20Kubu%20ve%20v%u011Bci%20zpracov%E1n%ED%20st%E1tn%ED%20ener
56475,149,1348092000,28,1,13,0,42,R,P%EDsemn%E1%20interpelace%20M.%20V%E1ni%20na%20P.%20Ne%u010Dase%20ve%20v%u011Bci%20v%20jak%E9m%20stavu%20je%20na%u0161
56476,149,1348092000,54,50,2,0,106,A,P%EDsemn%E1%20interpelace%20M.%20V%E1ni%20na%20P.%20Ne%u010Dase%20ve%20v%u011Bci%20v%20jak%E9m%20stavu%20je%20na%u0161
56477,149,1348092000,55,51,6,0,112,R,P%EDsemn%E1%20interpelace%20M.%20V%E1ni%20na%20P.%20Ne%u010Dase%20ve%20v%u011Bci%20Vl%E1da%20je%20soci%E1ln%u011B%20ne
56478,97,1348092000,107,1,12,0,120,A,Doh.mezi%20vl%E1dou%20%u010CR%20a%20vl%E1dou%20St%E1tu%20Katar%20o%20leteck%E9%20doprav%u011B
56479,98,1348092000,97,1,26,2,126,A,%DAml.o%20potla%u010D.%20protipr%E1vn%EDch%20%u010Din%u016F%20souvis.%20s%20mezin%E1r.letectv%EDm
56480,99,1348092000,109,0,20,2,131,A,Doh.%20o%20zalo%u017Een%ED%20Evropsk%E9%20banky%20pro%20obnovu%20a%20rozvoj
56481,100,1348092000,111,1,19,2,133,A,Zm%u011Bna%20P%u0159%EDlohy%20I%20Mezin%E1rodn%ED%20%FAmluvy%20proti%20dopingu%20ve%20sportu
56482,101,1348092000,111,0,22,1,134,A,Prot.%20a%20doh.mezi%20%u010CR%20a%20vl.Vietnam.soc.rep.%20o%20let.slu%u017Eb%E1ch
56483,102,1348092000,117,0,18,0,135,A,Sml.mezi%20%u010CR%20a%20Rakouskou%20rep.%20o%20zamezen%ED%20dvoj%EDmu%20zdan%u011Bn%ED
56484,103,1348092000,115,0,18,1,134,A,Smlouva%20Kolum.rep.-%u010CR%20dvoj%ED%20zdan%u011Bn%ED
56485,104,1348092000,112,1,19,1,133,A,Sml.mezi%20%u010CR%20a%20vl.%20Kr%E1l.%20Sa%FAdsk%E9%20Ar%E1bie%20o%20zamez.dvoj.zdan%u011Bn%ED
56486,105,1348092000,113,0,21,0,134,A,Prot.mezi%20%u010CR%20a%20vl.St%E1tu%20Izrael%20o%20leteck%E9%20doprav%u011B
56487,106,1348092000,108,1,23,1,133,A,%DAml.o%20odpov%u011Bdnosti%20za%20%u0161kody%20zp%u016Fsoben%E9%20ropn%FDmi%20palivy
56488,106,1348092000,116,0,17,0,133,A,%DAml.o%20odpov%u011Bdnosti%20za%20%u0161kody%20zp%u016Fsoben%E9%20ropn%FDmi%20palivy
56489,107,1348092000,110,0,22,1,133,A,Sml.%20mezi%20%u010CR%20a%20Rep.%20Makedonie%20o%20mezin%E1rodn%ED%20silni%u010Dn%ED%20doprav%u011B
56490,108,1348092000,115,0,17,1,133,A,Zm%u011Bny%20Dohody%20o%20Mezin%E1rodn%EDm%20m%u011Bnov%E9m%20fondu
56491,109,1348092000,114,0,19,0,133,A,Sml.%20o%20spolupr%E1ci%20v%20oblasti%20ochrany%20sv%u011Bdk%u016F
56492,110,1348092000,109,0,24,0,133,A,Sml.mezi%20%u010CR%20a%20%u010Cernou%20Horou%20o%20spol.%20v%20boji%20proti%20tr.%u010Dinnosti
56493,111,1348092000,105,0,25,1,131,A,Doh.%20o%20leteck%E9%20doprav%u011B
56494,112,1348092000,100,0,31,0,131,A,Zm%u011Bny%20%DAstavy%20a%20%DAmluvy%20Mezin%E1rodn%ED%20telekomunika%u010Dn%ED%20unie
56495,113,1348092000,94,1,35,0,130,A,Sml.mezi%20%u010CR%20a%20Ma%u010Farskem%20o%20ochran%u011B%20utaj.informac%ED
56496,117,1348092000,99,1,30,0,130,A,Sml.%20mezi%20%u010CR%20a%20Panamskou%20rep.%20o%20zamezen%ED%20dvoj%EDmu%20zdan%u011Bn%ED
56497,117,1348092000,106,0,24,0,130,A,Sml.%20mezi%20%u010CR%20a%20Panamskou%20rep.%20o%20zamezen%ED%20dvoj%EDmu%20zdan%u011Bn%ED
56498,20,1348092000,4,102,5,2,113,R,Novela%20z.%20-%20horn%ED%20z%E1kon
56499,20,1348092000,49,62,3,1,115,R,Novela%20z.%20-%20horn%ED%20z%E1kon
56500,20,1348092000,42,60,3,1,106,R,Novela%20z.%20-%20horn%ED%20z%E1kon
56501,0,1348178400,148,2,3,0,153,A,Po%u0159ad%20sch%u016Fze
56502,0,1348178400,149,3,4,0,156,A,Po%u0159ad%20sch%u016Fze
56503,0,1348178400,71,54,13,18,156,R,Po%u0159ad%20sch%u016Fze
56504,0,1348178400,121,6,26,4,157,A,Po%u0159ad%20sch%u016Fze
56505,0,1348178400,147,2,8,1,158,A,Po%u0159ad%20sch%u016Fze
56506,142,1348178400,144,1,11,2,158,A,Zpr%E1va%20o%20finan%u010Dn%ED%20stabilit%u011B%202011/2012
56507,143,1348178400,100,40,20,1,161,A,Zpr%E1va%20o%20v%FDkonu%20dohledu%20nad%20finan%u010Dn%EDm%20trhem%20za%20rok%202011
56508,144,1348178400,102,8,45,6,161,A,Zpr%E1va%20o%20inflaci%20-%20%u010Dervenec%202012
56509,148,1348178400,139,1,25,0,165,A,N%E1vrh%20%u010Dasov%E9ho%20harmonogramu%20projedn%E1v%E1n%ED%20vl%E1dn%EDho%20n%E1vrhu%20z%E1kona%20o%20st%E1t
56510,151,1348178400,103,4,13,5,125,A,Vl.n.z.%20o%20podm%EDnk%E1ch%20obch.%20s%20povol.%20na%20emise%20sklen%EDk.plyn%u016F%20-%20EU
56511,118,1348178400,69,77,1,0,147,R,Vl.n.z.%20o%20zru%u0161en%ED%20z%E1kona%20o%20%FArazov%E9m%20poji%u0161t%u011Bn%ED%20zam%u011Bstnanc%u016F
56512,118,1348178400,69,76,2,0,147,R,Vl.n.z.%20o%20zru%u0161en%ED%20z%E1kona%20o%20%FArazov%E9m%20poji%u0161t%u011Bn%ED%20zam%u011Bstnanc%u016F
56513,118,1348178400,139,2,5,1,147,A,Vl.n.z.%20o%20zru%u0161en%ED%20z%E1kona%20o%20%FArazov%E9m%20poji%u0161t%u011Bn%ED%20zam%u011Bstnanc%u016F
56514,118,1348178400,78,64,5,0,147,A,Vl.n.z.%20o%20zru%u0161en%ED%20z%E1kona%20o%20%FArazov%E9m%20poji%u0161t%u011Bn%ED%20zam%u011Bstnanc%u016F
56515,47,1348178400,113,0,34,0,147,A,Novela%20z.%20o%20specifick%FDch%20zdravotn%EDch%20slu%u017Eb%E1ch
56516,0,1348524000,65,0,66,0,131,R,Po%u0159ad%20sch%u016Fze
56517,0,1348524000,124,3,6,5,138,A,Po%u0159ad%20sch%u016Fze
56518,0,1348524000,131,5,6,2,144,A,Po%u0159ad%20sch%u016Fze
56519,0,1348524000,101,38,6,0,145,A,Po%u0159ad%20sch%u016Fze
56520,0,1348524000,145,2,2,0,149,A,Po%u0159ad%20sch%u016Fze
56521,0,1348524000,145,2,1,1,149,A,Po%u0159ad%20sch%u016Fze
56522,0,1348524000,75,56,9,9,149,A,Po%u0159ad%20sch%u016Fze
56523,0,1348524000,123,9,15,2,149,A,Po%u0159ad%20sch%u016Fze
56524,0,1348524000,70,65,9,5,149,R,Po%u0159ad%20sch%u016Fze
56525,0,1348524000,67,65,8,10,150,R,Po%u0159ad%20sch%u016Fze
56526,0,1348524000,68,67,9,6,150,R,Po%u0159ad%20sch%u016Fze
56527,0,1348524000,66,65,13,6,150,R,Po%u0159ad%20sch%u016Fze
56528,0,1348524000,65,72,8,5,150,R,Po%u0159ad%20sch%u016Fze
56529,0,1348524000,139,6,5,0,150,A,Po%u0159ad%20sch%u016Fze
56530,132,1348524000,140,0,11,0,151,A,N%E1vrh%20na%20zm%u011Bny%20ve%20slo%u017Een%ED%20org%E1n%u016F%20Poslaneck%E9%20sn%u011Bmovny
56531,132,1348524000,142,0,9,0,151,A,N%E1vrh%20na%20zm%u011Bny%20ve%20slo%u017Een%ED%20org%E1n%u016F%20Poslaneck%E9%20sn%u011Bmovny
56532,133,1348524000,136,1,16,0,153,A,N%E1vrh%20na%20jmenov%E1n%ED%20%u010Dlena%20RRTV
56533,87,1348524000,81,62,2,2,147,A,Novela%20z.%20o%20zdravotn%EDch%20slu%u017Eb%E1ch
56534,91,1348524000,85,20,13,16,134,A,Novela%20z.%20o%20poji%u0161%u0165ovnictv%ED
56535,94,1348524000,73,58,11,1,143,A,N.z.%20o%20soci%E1ln%EDm%20bydlen%ED
56536,95,1348524000,69,41,23,12,145,R,Novela%20z.%20o%20loteri%EDch
56537,95,1348524000,123,2,21,2,148,A,Novela%20z.%20o%20loteri%EDch
56538,95,1348524000,96,12,30,10,148,A,Novela%20z.%20o%20loteri%EDch
56539,96,1348524000,69,43,16,6,134,A,Novela%20z.%20-%20trestn%ED%20z%E1kon%EDk
56540,39,1348524000,43,75,7,12,137,R,Vl.n.z.%20o%20zm%u011Bn%u011B%20z%E1k.%20v%20oblasti%20poji%u0161%u0165ov.%20a%20penzij.%20p%u0159ipoji%u0161.%20-%20EU
56541,39,1348524000,127,2,8,0,137,A,Vl.n.z.%20o%20zm%u011Bn%u011B%20z%E1k.%20v%20oblasti%20poji%u0161%u0165ov.%20a%20penzij.%20p%u0159ipoji%u0161.%20-%20EU
56542,39,1348524000,74,31,23,9,137,A,Vl.n.z.%20o%20zm%u011Bn%u011B%20z%E1k.%20v%20oblasti%20poji%u0161%u0165ov.%20a%20penzij.%20p%u0159ipoji%u0161.%20-%20EU
56543,39,1348524000,59,60,7,3,129,R,Vl.n.z.%20o%20zm%u011Bn%u011B%20z%E1k.%20v%20oblasti%20poji%u0161%u0165ov.%20a%20penzij.%20p%u0159ipoji%u0161.%20-%20EU
56544,39,1348524000,69,37,17,9,132,A,Vl.n.z.%20o%20zm%u011Bn%u011B%20z%E1k.%20v%20oblasti%20poji%u0161%u0165ov.%20a%20penzij.%20p%u0159ipoji%u0161.%20-%20EU
56545,39,1348524000,124,2,7,0,133,A,Vl.n.z.%20o%20zm%u011Bn%u011B%20z%E1k.%20v%20oblasti%20poji%u0161%u0165ov.%20a%20penzij.%20p%u0159ipoji%u0161.%20-%20EU
56546,39,1348524000,68,51,10,6,135,A,Vl.n.z.%20o%20zm%u011Bn%u011B%20z%E1k.%20v%20oblasti%20poji%u0161%u0165ov.%20a%20penzij.%20p%u0159ipoji%u0161.%20-%20EU
56547,0,1348610400,145,4,4,2,155,A,Po%u0159ad%20sch%u016Fze
56548,0,1348610400,106,21,10,19,156,A,Po%u0159ad%20sch%u016Fze
56549,0,1348610400,95,13,29,19,156,A,Po%u0159ad%20sch%u016Fze
56550,0,1348610400,80,40,19,15,154,A,Po%u0159ad%20sch%u016Fze
56551,0,1348610400,117,5,24,8,154,A,Po%u0159ad%20sch%u016Fze
56552,0,1348610400,74,45,13,20,152,R,Po%u0159ad%20sch%u016Fze
56553,0,1348610400,76,65,7,8,156,R,Po%u0159ad%20sch%u016Fze
56554,123,1348610400,149,0,6,2,157,A,Novela%20z.%20-%20z%E1kon%EDk%20pr%E1ce
56555,123,1348610400,150,0,4,3,157,A,Novela%20z.%20-%20z%E1kon%EDk%20pr%E1ce
56556,152,1348610400,148,1,8,1,158,A,Vl.n.z.%20o%20podm%EDnk%E1ch%20obch.%20s%20povol.%20na%20emise%20sklen%EDk.plyn%u016F%20-%20EU
56557,152,1348610400,46,81,12,19,158,R,Vl.n.z.%20o%20podm%EDnk%E1ch%20obch.%20s%20povol.%20na%20emise%20sklen%EDk.plyn%u016F%20-%20EU
56558,152,1348610400,101,20,10,26,157,A,Vl.n.z.%20o%20podm%EDnk%E1ch%20obch.%20s%20povol.%20na%20emise%20sklen%EDk.plyn%u016F%20-%20EU
56559,152,1348610400,1,25,123,10,159,R,Vl.n.z.%20o%20podm%EDnk%E1ch%20obch.%20s%20povol.%20na%20emise%20sklen%EDk.plyn%u016F%20-%20EU
56560,152,1348610400,25,90,18,26,159,R,Vl.n.z.%20o%20podm%EDnk%E1ch%20obch.%20s%20povol.%20na%20emise%20sklen%EDk.plyn%u016F%20-%20EU
56561,152,1348610400,24,85,29,21,159,R,Vl.n.z.%20o%20podm%EDnk%E1ch%20obch.%20s%20povol.%20na%20emise%20sklen%EDk.plyn%u016F%20-%20EU
56562,152,1348610400,19,77,41,22,159,R,Vl.n.z.%20o%20podm%EDnk%E1ch%20obch.%20s%20povol.%20na%20emise%20sklen%EDk.plyn%u016F%20-%20EU
56563,152,1348610400,21,87,30,21,159,R,Vl.n.z.%20o%20podm%EDnk%E1ch%20obch.%20s%20povol.%20na%20emise%20sklen%EDk.plyn%u016F%20-%20EU
56564,152,1348610400,19,79,41,20,159,R,Vl.n.z.%20o%20podm%EDnk%E1ch%20obch.%20s%20povol.%20na%20emise%20sklen%EDk.plyn%u016F%20-%20EU
56565,152,1348610400,26,93,21,19,159,R,Vl.n.z.%20o%20podm%EDnk%E1ch%20obch.%20s%20povol.%20na%20emise%20sklen%EDk.plyn%u016F%20-%20EU
56566,152,1348610400,7,71,69,12,159,R,Vl.n.z.%20o%20podm%EDnk%E1ch%20obch.%20s%20povol.%20na%20emise%20sklen%EDk.plyn%u016F%20-%20EU
56567,152,1348610400,21,96,22,20,159,R,Vl.n.z.%20o%20podm%EDnk%E1ch%20obch.%20s%20povol.%20na%20emise%20sklen%EDk.plyn%u016F%20-%20EU
56568,152,1348610400,24,96,13,26,159,R,Vl.n.z.%20o%20podm%EDnk%E1ch%20obch.%20s%20povol.%20na%20emise%20sklen%EDk.plyn%u016F%20-%20EU
56569,152,1348610400,23,95,19,22,159,R,Vl.n.z.%20o%20podm%EDnk%E1ch%20obch.%20s%20povol.%20na%20emise%20sklen%EDk.plyn%u016F%20-%20EU
56570,152,1348610400,24,97,16,22,159,R,Vl.n.z.%20o%20podm%EDnk%E1ch%20obch.%20s%20povol.%20na%20emise%20sklen%EDk.plyn%u016F%20-%20EU
56571,152,1348610400,24,95,22,18,159,R,Vl.n.z.%20o%20podm%EDnk%E1ch%20obch.%20s%20povol.%20na%20emise%20sklen%EDk.plyn%u016F%20-%20EU
56572,152,1348610400,103,18,15,22,158,A,Vl.n.z.%20o%20podm%EDnk%E1ch%20obch.%20s%20povol.%20na%20emise%20sklen%EDk.plyn%u016F%20-%20EU
56573,152,1348610400,8,96,29,26,159,R,Vl.n.z.%20o%20podm%EDnk%E1ch%20obch.%20s%20povol.%20na%20emise%20sklen%EDk.plyn%u016F%20-%20EU
56574,152,1348610400,24,94,24,17,159,R,Vl.n.z.%20o%20podm%EDnk%E1ch%20obch.%20s%20povol.%20na%20emise%20sklen%EDk.plyn%u016F%20-%20EU
56575,152,1348610400,44,91,13,11,159,R,Vl.n.z.%20o%20podm%EDnk%E1ch%20obch.%20s%20povol.%20na%20emise%20sklen%EDk.plyn%u016F%20-%20EU
56576,152,1348610400,33,97,17,12,159,R,Vl.n.z.%20o%20podm%EDnk%E1ch%20obch.%20s%20povol.%20na%20emise%20sklen%EDk.plyn%u016F%20-%20EU
56577,152,1348610400,41,93,14,11,159,R,Vl.n.z.%20o%20podm%EDnk%E1ch%20obch.%20s%20povol.%20na%20emise%20sklen%EDk.plyn%u016F%20-%20EU
56578,152,1348610400,103,14,14,28,159,A,Vl.n.z.%20o%20podm%EDnk%E1ch%20obch.%20s%20povol.%20na%20emise%20sklen%EDk.plyn%u016F%20-%20EU
56579,130,1348610400,137,2,14,5,158,A,Novela%20z.%20-%20%u0161kolsk%FD%20z%E1kon
56580,130,1348610400,141,1,13,3,158,A,Novela%20z.%20-%20%u0161kolsk%FD%20z%E1kon
56581,130,1348610400,142,0,12,4,158,A,Novela%20z.%20-%20%u0161kolsk%FD%20z%E1kon
56582,128,1348610400,128,1,25,1,155,A,Novela%20z.%20o%20soci%E1ln%EDch%20slu%u017Eb%E1ch
56583,119,1348610400,138,0,17,1,156,A,Novela%20z.%20-%20ob%u010Dansk%FD%20soudn%ED%20%u0159%E1d%20-%20EU
56584,119,1348610400,9,80,44,23,156,R,Novela%20z.%20-%20ob%u010Dansk%FD%20soudn%ED%20%u0159%E1d%20-%20EU
56585,119,1348610400,48,54,28,25,155,R,Novela%20z.%20-%20ob%u010Dansk%FD%20soudn%ED%20%u0159%E1d%20-%20EU
56586,119,1348610400,143,1,11,1,156,A,Novela%20z.%20-%20ob%u010Dansk%FD%20soudn%ED%20%u0159%E1d%20-%20EU
56587,119,1348610400,125,22,1,1,149,A,Novela%20z.%20-%20ob%u010Dansk%FD%20soudn%ED%20%u0159%E1d%20-%20EU
56588,120,1348610400,72,72,5,3,152,R,Novela%20z.%20o%20dani%20z%20p%u0159idan%E9%20hodnoty%20-%20EU
56589,120,1348610400,81,44,22,5,152,A,Novela%20z.%20o%20dani%20z%20p%u0159idan%E9%20hodnoty%20-%20EU
56590,120,1348610400,144,0,7,1,152,A,Novela%20z.%20o%20dani%20z%20p%u0159idan%E9%20hodnoty%20-%20EU
56591,120,1348610400,77,47,21,5,150,A,Novela%20z.%20o%20dani%20z%20p%u0159idan%E9%20hodnoty%20-%20EU
56592,120,1348610400,152,0,1,0,153,A,Novela%20z.%20o%20dani%20z%20p%u0159idan%E9%20hodnoty%20-%20EU
56593,120,1348610400,61,84,4,2,151,R,Novela%20z.%20o%20dani%20z%20p%u0159idan%E9%20hodnoty%20-%20EU
56594,120,1348610400,72,76,1,3,152,R,Novela%20z.%20o%20dani%20z%20p%u0159idan%E9%20hodnoty%20-%20EU
56595,120,1348610400,96,27,24,7,154,A,Novela%20z.%20o%20dani%20z%20p%u0159idan%E9%20hodnoty%20-%20EU
56596,120,1348610400,91,39,16,5,151,A,Novela%20z.%20o%20dani%20z%20p%u0159idan%E9%20hodnoty%20-%20EU
56597,121,1348610400,59,74,12,3,148,R,Novela%20z.%20o%20spot%u0159ebn%EDch%20dan%EDch%20-%20EU
56598,121,1348610400,135,1,12,0,148,A,Novela%20z.%20o%20spot%u0159ebn%EDch%20dan%EDch%20-%20EU
56599,121,1348610400,107,6,15,20,148,A,Novela%20z.%20o%20spot%u0159ebn%EDch%20dan%EDch%20-%20EU
56600,121,1348610400,49,86,11,2,148,R,Novela%20z.%20o%20spot%u0159ebn%EDch%20dan%EDch%20-%20EU
56601,121,1348610400,42,74,20,7,143,R,Novela%20z.%20o%20spot%u0159ebn%EDch%20dan%EDch%20-%20EU
56602,121,1348610400,61,70,13,3,147,R,Novela%20z.%20o%20spot%u0159ebn%EDch%20dan%EDch%20-%20EU
56603,121,1348610400,107,6,14,19,146,A,Novela%20z.%20o%20spot%u0159ebn%EDch%20dan%EDch%20-%20EU
56604,121,1348610400,84,31,25,7,147,A,Novela%20z.%20o%20spot%u0159ebn%EDch%20dan%EDch%20-%20EU
56605,122,1348610400,123,0,23,0,146,A,Novela%20z.%20o%20provozov%E1n%ED%20rozhlasov%E9ho%20a%20tel.%20vys%EDl%E1n%ED
56606,122,1348610400,122,0,20,4,146,A,Novela%20z.%20o%20provozov%E1n%ED%20rozhlasov%E9ho%20a%20tel.%20vys%EDl%E1n%ED
56607,124,1348610400,120,0,23,1,144,A,Vl.n.z.%20o%20audiovizi
56608,124,1348610400,124,0,21,0,145,A,Vl.n.z.%20o%20audiovizi
56609,124,1348610400,10,74,47,14,145,R,Vl.n.z.%20o%20audiovizi
56610,124,1348610400,125,1,18,0,144,A,Vl.n.z.%20o%20audiovizi
56611,124,1348610400,126,1,18,0,145,A,Vl.n.z.%20o%20audiovizi
56612,124,1348610400,128,0,16,1,145,A,Vl.n.z.%20o%20audiovizi
56613,125,1348610400,60,61,2,2,125,R,Novela%20z.%20o%20rozpo%u010Dtov%FDch%20pravidlech
56614,125,1348610400,59,66,4,2,131,R,Novela%20z.%20o%20rozpo%u010Dtov%FDch%20pravidlech
56615,125,1348610400,125,3,5,0,133,A,Novela%20z.%20o%20rozpo%u010Dtov%FDch%20pravidlech
56616,125,1348610400,129,2,2,0,133,A,Novela%20z.%20o%20rozpo%u010Dtov%FDch%20pravidlech
56617,125,1348610400,113,1,17,3,134,A,Novela%20z.%20o%20rozpo%u010Dtov%FDch%20pravidlech
56618,125,1348610400,51,59,12,12,134,R,Novela%20z.%20o%20rozpo%u010Dtov%FDch%20pravidlech
56619,125,1348610400,81,29,19,3,132,A,Novela%20z.%20o%20rozpo%u010Dtov%FDch%20pravidlech
56620,126,1348610400,107,0,22,0,129,A,Novela%20z.%20o%20vyvlastn%u011Bn%ED
56621,126,1348610400,114,0,13,1,128,A,Novela%20z.%20o%20vyvlastn%u011Bn%ED
56622,126,1348610400,60,40,17,11,128,R,Novela%20z.%20o%20vyvlastn%u011Bn%ED
56623,126,1348610400,103,9,11,6,129,A,Novela%20z.%20o%20vyvlastn%u011Bn%ED
56624,127,1348610400,113,0,15,0,128,A,Vl.n.z.%20o%20St%E1tn%EDm%20pozemkov%E9m%20%FA%u0159adu
56625,127,1348610400,115,1,12,0,128,A,Vl.n.z.%20o%20St%E1tn%EDm%20pozemkov%E9m%20%FA%u0159adu
56626,127,1348610400,118,0,10,0,128,A,Vl.n.z.%20o%20St%E1tn%EDm%20pozemkov%E9m%20%FA%u0159adu
56627,127,1348610400,117,0,11,0,128,A,Vl.n.z.%20o%20St%E1tn%EDm%20pozemkov%E9m%20%FA%u0159adu
56628,127,1348610400,120,0,9,0,129,A,Vl.n.z.%20o%20St%E1tn%EDm%20pozemkov%E9m%20%FA%u0159adu
56629,127,1348610400,71,6,33,19,129,A,Vl.n.z.%20o%20St%E1tn%EDm%20pozemkov%E9m%20%FA%u0159adu
56630,127,1348610400,57,60,10,2,129,R,Vl.n.z.%20o%20St%E1tn%EDm%20pozemkov%E9m%20%FA%u0159adu
56631,127,1348610400,56,60,10,3,129,R,Vl.n.z.%20o%20St%E1tn%EDm%20pozemkov%E9m%20%FA%u0159adu
56632,127,1348610400,73,42,10,5,130,A,Vl.n.z.%20o%20St%E1tn%EDm%20pozemkov%E9m%20%FA%u0159adu
56633,129,1348610400,47,72,2,1,122,R,Novela%20z.%20-%20horn%ED%20z%E1kon
56634,129,1348610400,47,70,7,0,124,R,Novela%20z.%20-%20horn%ED%20z%E1kon
56635,129,1348610400,47,67,9,1,124,R,Novela%20z.%20-%20horn%ED%20z%E1kon
56636,129,1348610400,121,0,1,0,122,A,Novela%20z.%20-%20horn%ED%20z%E1kon
56637,129,1348610400,44,74,3,1,122,R,Novela%20z.%20-%20horn%ED%20z%E1kon
56638,129,1348610400,45,74,4,0,123,R,Novela%20z.%20-%20horn%ED%20z%E1kon
56639,129,1348610400,43,72,7,1,123,R,Novela%20z.%20-%20horn%ED%20z%E1kon
56640,129,1348610400,76,45,2,1,124,A,Novela%20z.%20-%20horn%ED%20z%E1kon
56641,131,1348610400,113,2,7,0,122,A,Novela%20z.%20o%20dopl%u0148kov%E9m%20penzijn%EDm%20spo%u0159en%ED
56642,131,1348610400,30,68,11,13,122,R,Novela%20z.%20o%20dopl%u0148kov%E9m%20penzijn%EDm%20spo%u0159en%ED
56643,131,1348610400,115,0,7,0,122,A,Novela%20z.%20o%20dopl%u0148kov%E9m%20penzijn%EDm%20spo%u0159en%ED
56644,41,1348610400,108,0,13,0,121,A,Novela%20z.%20o%20spot%u0159ebitelsk%E9m%20%FAv%u011Bru%20-%20EU
56645,41,1348610400,85,17,18,2,122,A,Novela%20z.%20o%20spot%u0159ebitelsk%E9m%20%FAv%u011Bru%20-%20EU
56646,42,1348610400,111,0,9,1,121,A,Novela%20z.o%20n%u011Bkter.opat%u0159en.proti%20leg.v%FDnos%u016F%20z%20trest.%u010Dinnosti%20-%20EU
56647,42,1348610400,107,1,13,0,121,A,Novela%20z.o%20n%u011Bkter.opat%u0159en.proti%20leg.v%FDnos%u016F%20z%20trest.%u010Dinnosti%20-%20EU
56648,0,1348610400,86,14,14,3,117,A,%20
56649,0,1350943200,148,0,26,0,174,A,%20
56650,0,1350943200,151,20,19,2,192,A,Po%u0159ad%20sch%u016Fze
56651,0,1350943200,187,1,6,0,194,A,Po%u0159ad%20sch%u016Fze
56652,0,1350943200,131,12,27,21,191,A,Po%u0159ad%20sch%u016Fze
56653,0,1350943200,108,34,36,14,192,A,Po%u0159ad%20sch%u016Fze
56654,0,1350943200,109,21,38,25,193,A,Po%u0159ad%20sch%u016Fze
56655,0,1350943200,89,78,13,12,192,R,Po%u0159ad%20sch%u016Fze
56656,0,1350943200,161,7,14,11,193,A,Po%u0159ad%20sch%u016Fze
56657,0,1350943200,138,14,16,25,193,A,Po%u0159ad%20sch%u016Fze
56658,0,1350943200,92,83,11,6,192,R,Po%u0159ad%20sch%u016Fze
56659,0,1350943200,90,86,10,7,193,R,Po%u0159ad%20sch%u016Fze
56660,0,1350943200,83,83,15,12,193,R,Po%u0159ad%20sch%u016Fze
56661,0,1350943200,79,101,8,6,194,R,Po%u0159ad%20sch%u016Fze
56662,0,1350943200,84,88,8,5,185,R,Po%u0159ad%20sch%u016Fze
56663,0,1350943200,156,12,12,10,190,A,Po%u0159ad%20sch%u016Fze
56664,0,1350943200,90,89,8,5,192,R,Po%u0159ad%20sch%u016Fze
56665,0,1350943200,91,93,3,5,192,R,Po%u0159ad%20sch%u016Fze
56666,0,1350943200,148,16,12,16,192,A,Po%u0159ad%20sch%u016Fze
56667,0,1350943200,153,19,11,10,193,A,Po%u0159ad%20sch%u016Fze
56668,0,1350943200,57,83,36,17,193,R,Po%u0159ad%20sch%u016Fze
56669,0,1350943200,89,89,9,6,193,R,Po%u0159ad%20sch%u016Fze
56670,0,1350943200,92,85,9,7,193,R,Po%u0159ad%20sch%u016Fze
56671,0,1350943200,1,2,160,0,163,R,Po%u0159ad%20sch%u016Fze
56672,0,1350943200,89,88,5,7,189,R,Po%u0159ad%20sch%u016Fze
56673,0,1350943200,175,1,16,1,193,A,Po%u0159ad%20sch%u016Fze
56674,0,1350943200,92,91,5,5,193,R,Po%u0159ad%20sch%u016Fze
56675,0,1350943200,145,14,18,16,193,A,Po%u0159ad%20sch%u016Fze
56676,0,1350943200,176,7,8,2,193,A,Po%u0159ad%20sch%u016Fze
56677,0,1350943200,111,46,14,22,193,A,Po%u0159ad%20sch%u016Fze
56678,0,1350943200,113,49,14,17,193,A,Po%u0159ad%20sch%u016Fze
56679,0,1350943200,90,89,5,8,192,R,Po%u0159ad%20sch%u016Fze
56680,0,1350943200,186,1,6,0,193,A,Po%u0159ad%20sch%u016Fze
56681,0,1350943200,102,84,5,2,193,A,Po%u0159ad%20sch%u016Fze
56682,1,1350943200,138,13,30,9,190,A,N%E1vrh%20na%20zkr%E1cen%ED%20lh%u016Fty%20pro%20projedn%E1n%ED%20sn%u011Bmovn%EDho%20tisku%20725
56683,86,1350943200,151,0,33,0,184,A,Novela%20%FAstav.%20z.%20-%20%DAstava%20%u010Cesk%E9%20republiky
56684,86,1350943200,20,89,59,17,185,R,Novela%20%FAstav.%20z.%20-%20%DAstava%20%u010Cesk%E9%20republiky
56685,87,1350943200,115,0,66,2,183,A,Novela%20%FAstav.%20z.%20-%20%DAstava%20%u010Cesk%E9%20republiky
56686,88,1350943200,127,1,53,0,181,A,N.z.%20o%20%u010Cesk%E9m%20n%E1rodn%EDm%20povst%E1n%ED
56687,89,1350943200,77,53,22,5,157,R,Novela%20z.%20o%20sdru%u017Eov%E1n%ED%20v%20politick%FDch%20stran%E1ch%20a%20hnut%EDch
56688,89,1350943200,150,6,6,0,162,A,Novela%20z.%20o%20sdru%u017Eov%E1n%ED%20v%20politick%FDch%20stran%E1ch%20a%20hnut%EDch
56689,89,1350943200,85,52,20,6,163,A,Novela%20z.%20o%20sdru%u017Eov%E1n%ED%20v%20politick%FDch%20stran%E1ch%20a%20hnut%EDch
56690,89,1350943200,152,2,10,1,165,A,Novela%20z.%20o%20sdru%u017Eov%E1n%ED%20v%20politick%FDch%20stran%E1ch%20a%20hnut%EDch
56691,89,1350943200,85,56,19,5,165,A,Novela%20z.%20o%20sdru%u017Eov%E1n%ED%20v%20politick%FDch%20stran%E1ch%20a%20hnut%EDch
56692,91,1350943200,141,1,22,1,165,A,Novela%20z.%20o%20silni%u010Dn%EDm%20provozu
56693,0,1351029600,121,2,30,2,155,A,Po%u0159ad%20sch%u016Fze
56694,0,1351029600,76,45,26,12,159,R,Po%u0159ad%20sch%u016Fze
56695,0,1351029600,90,9,41,23,163,A,Po%u0159ad%20sch%u016Fze
56696,2,1351029600,127,9,11,29,176,A,Vl.n.z.%20o%20st%E1tn%EDm%20rozpo%u010Dtu%20%u010CR%20na%20rok%202013
56697,45,1351029600,146,1,28,2,177,A,Novela%20z.%20o%20Pozemkov%E9m%20fondu%20%u010CR
56698,45,1351029600,135,10,30,2,177,A,Novela%20z.%20o%20Pozemkov%E9m%20fondu%20%u010CR
56699,10,1351029600,45,61,70,7,183,R,Novela%20z.%20o%20finan%u010Dn%ED%20kontrole%20-%20EU
56700,10,1351029600,78,73,30,4,185,R,Novela%20z.%20o%20finan%u010Dn%ED%20kontrole%20-%20EU
56701,0,1351116000,69,2,9,1,81,A,Po%u0159ad%20sch%u016Fze
56702,129,1351116000,35,39,1,0,75,R,P%EDsemn%E1%20interpelace%20M.%20Greben%ED%u010Dka%20na%20P.%20Ne%u010Dase%20ve%20v%u011Bci%20podez%u0159en%ED%20vl%E1dy
56703,129,1351116000,60,8,10,1,79,A,P%EDsemn%E1%20interpelace%20K.%20Kone%u010Dn%E9%20na%20T.%20Chalupu%20ve%20v%u011Bci%20postupu%20Odboru%20oc
56704,129,1351116000,54,6,21,0,81,A,P%EDsemn%E1%20interpelace%20H.%20Orgon%EDkov%E9%20na%20P.%20Dobe%u0161e%20ve%20v%u011Bci%20nutn%E9ho%20zahrnut
56705,129,1351116000,44,11,22,4,81,A,P%EDsemn%E1%20interpelace%20K.%20Klasnov%E9%20na%20P.%20Ne%u010Dase%20ve%20v%u011Bci%20vl%E1dn%EDho%20postoje
56706,129,1351116000,42,23,16,2,83,A,P%EDsemn%E1%20interpelace%20M.%20V%E1ni%20na%20P.%20Ne%u010Dase%20ve%20v%u011Bci%20z%E1kona%20o%20majetkov%E9m%20v
56707,93,1351116000,70,29,13,2,114,A,R%E1mec%20pro%20ozdravn%E9%20postupy%20a%20%u0159e%u0161en%ED%20probl%E9m%u016F%20%FAv%u011Br.instituc%ED
56708,93,1351116000,119,0,1,1,121,A,R%E1mec%20pro%20ozdravn%E9%20postupy%20a%20%u0159e%u0161en%ED%20probl%E9m%u016F%20%FAv%u011Br.instituc%ED
56709,93,1351116000,73,33,13,3,122,A,R%E1mec%20pro%20ozdravn%E9%20postupy%20a%20%u0159e%u0161en%ED%20probl%E9m%u016F%20%FAv%u011Br.instituc%ED
56710,26,1351116000,106,1,21,1,129,A,Novela%20z.%20o%20regulaci%20reklamy%20-%20EU
56711,0,1351202400,130,1,24,2,157,A,%20
56712,0,1351202400,111,9,38,3,161,A,%20
56713,0,1351202400,100,32,25,7,164,A,%20
56714,0,1351202400,89,35,35,5,164,A,%20
56715,12,1351202400,116,1,48,1,166,A,Novela%20z.%20o%20l%E9%u010Divech
56716,30,1351202400,125,0,40,0,165,A,Novela%20z.%20o%20integrovan%E9%20prevenci%20-%20EU
56717,30,1351202400,91,17,44,12,164,A,Novela%20z.%20o%20integrovan%E9%20prevenci%20-%20EU
56718,25,1351202400,103,0,60,0,163,A,Novela%20z.%20o%20odpadech%20-%20EU
56719,25,1351202400,114,0,47,2,163,A,Novela%20z.%20o%20odpadech%20-%20EU
56720,25,1351202400,91,16,48,8,163,A,Novela%20z.%20o%20odpadech%20-%20EU
56721,24,1351202400,115,0,43,0,158,A,Novela%20z.o%20podm%EDn.%20provozu%20vozidel%20na%20pozemn%EDch%20komunikac%EDch%20-%20EU
56722,24,1351202400,45,43,69,1,158,R,Novela%20z.o%20podm%EDn.%20provozu%20vozidel%20na%20pozemn%EDch%20komunikac%EDch%20-%20EU
56723,24,1351202400,74,57,4,1,136,A,Novela%20z.o%20podm%EDn.%20provozu%20vozidel%20na%20pozemn%EDch%20komunikac%EDch%20-%20EU
56724,31,1351202400,112,0,25,0,137,A,Novela%20z.%20o%20l%E9%u010Divech%20-%20EU
56725,31,1351202400,89,5,35,8,137,A,Novela%20z.%20o%20l%E9%u010Divech%20-%20EU
56726,38,1351202400,117,0,20,0,137,A,Novela%20z.%20o%20zdravotn%EDch%20slu%u017Eb%E1ch
56727,38,1351202400,120,0,20,0,140,A,Novela%20z.%20o%20zdravotn%EDch%20slu%u017Eb%E1ch
56728,38,1351202400,115,1,22,1,139,A,Novela%20z.%20o%20zdravotn%EDch%20slu%u017Eb%E1ch
56729,34,1351202400,110,0,29,0,139,A,Novela%20z.%20o%20silni%u010Dn%ED%20doprav%u011B%20-%20EU
56730,0,1351551600,100,83,2,2,187,A,%20
56731,0,1351551600,161,5,17,5,188,A,%20
56732,0,1351551600,175,4,9,2,190,A,%20
56733,0,1351551600,101,88,1,1,191,A,%20
56734,0,1352156400,160,2,7,1,170,A,Po%u0159ad%20sch%u016Fze
56735,0,1352156400,160,1,11,2,174,A,Po%u0159ad%20sch%u016Fze
56736,0,1352156400,164,0,14,0,178,A,Po%u0159ad%20sch%u016Fze
56737,0,1352156400,92,92,6,6,196,R,Po%u0159ad%20sch%u016Fze
56738,0,1352156400,186,1,6,3,196,A,Po%u0159ad%20sch%u016Fze
56739,0,1352156400,95,90,5,6,196,R,Po%u0159ad%20sch%u016Fze
56740,0,1352156400,180,4,11,1,196,A,Po%u0159ad%20sch%u016Fze
56741,0,1352156400,94,91,5,8,198,R,Po%u0159ad%20sch%u016Fze
56742,0,1352156400,25,111,36,26,198,R,Po%u0159ad%20sch%u016Fze
56743,0,1352156400,94,93,9,2,198,R,Po%u0159ad%20sch%u016Fze
56744,0,1352156400,177,12,5,4,198,A,Po%u0159ad%20sch%u016Fze
56745,0,1352156400,100,17,45,36,198,A,Po%u0159ad%20sch%u016Fze
56746,0,1352156400,99,64,17,17,197,A,Po%u0159ad%20sch%u016Fze
56747,0,1352156400,171,7,13,7,198,A,Po%u0159ad%20sch%u016Fze
56748,0,1352156400,126,58,10,4,198,A,Po%u0159ad%20sch%u016Fze
56749,0,1352156400,82,28,52,36,198,R,Po%u0159ad%20sch%u016Fze
56750,0,1352156400,176,4,15,3,198,A,Po%u0159ad%20sch%u016Fze
56751,0,1352156400,88,92,11,7,198,R,Po%u0159ad%20sch%u016Fze
56752,133,1352156400,130,3,59,3,195,A,Novela%20z.%20o%20Pozemkov%E9m%20fondu%20%u010CR
56753,134,1352156400,123,9,50,14,196,A,N%E1vrh%20nov%E9ho%20%u010Dasov%E9ho%20harmonogramu%20projedn%E1v%E1n%ED%20vl%E1dn%EDho%20n%E1vrhu%20z%E1kona
56754,73,1352156400,152,2,36,1,191,A,Novela%20z.%20o%20platu%20p%u0159edstavitel%u016F%20st%E1tn%ED%20moci
56755,73,1352156400,143,6,37,5,191,A,Novela%20z.%20o%20platu%20p%u0159edstavitel%u016F%20st%E1tn%ED%20moci
56756,36,1352156400,125,0,63,0,188,A,Novela%20z.%20-%20transplanta%u010Dn%ED%20z%E1kon%20-%20EU
56757,36,1352156400,98,6,72,12,188,A,Novela%20z.%20-%20transplanta%u010Dn%ED%20z%E1kon%20-%20EU
56758,61,1352156400,25,126,21,9,181,R,Novela%20z.%20o%20poji%u0161%u0165ovnictv%ED
56759,61,1352156400,155,1,21,4,181,A,Novela%20z.%20o%20poji%u0161%u0165ovnictv%ED
56760,61,1352156400,142,12,23,4,181,A,Novela%20z.%20o%20poji%u0161%u0165ovnictv%ED
56761,61,1352156400,116,32,29,4,181,A,Novela%20z.%20o%20poji%u0161%u0165ovnictv%ED
56762,61,1352156400,68,60,47,7,182,R,Novela%20z.%20o%20poji%u0161%u0165ovnictv%ED
56763,16,1352156400,124,2,50,2,178,A,Novela%20z.%20o%20podpo%u0159e%20v%FDzkumu%20a%20v%FDvoje
56764,18,1352156400,131,0,45,2,178,A,Vl.n.z.o%20opat%u0159en.ke%20zv%FD%u0161en%ED%20transparentnosti%20akciov%FDch%20spol.
56765,18,1352156400,82,32,52,13,179,R,Vl.n.z.o%20opat%u0159en.ke%20zv%FD%u0161en%ED%20transparentnosti%20akciov%FDch%20spol.
56766,19,1352156400,124,0,55,0,179,A,Vl.n.z.o%20mezin%E1rodn%ED%20justi%u010Dn%ED%20spolupr%E1ci%20ve%20v%u011Bcech%20trestn%EDch%20-%20EU
56767,19,1352156400,128,1,48,1,178,A,Vl.n.z.o%20mezin%E1rodn%ED%20justi%u010Dn%ED%20spolupr%E1ci%20ve%20v%u011Bcech%20trestn%EDch%20-%20EU
56768,20,1352156400,130,0,46,2,178,A,Vl.n.z.o%20zm%u011Bn%u011B%20z%E1k.v%20souv.s%20p%u0159ijet%EDm%20z.o%20mezin.just.spolupr.%20-%20EU
56769,0,1352242800,165,2,9,1,177,A,Po%u0159ad%20sch%u016Fze
56770,0,1352242800,172,4,5,1,182,A,Po%u0159ad%20sch%u016Fze
56771,0,1352242800,99,85,2,1,187,A,%20
56772,103,1352242800,186,6,4,2,198,A,Vl.n.z.%20o%20zm%u011Bn%u011B%20da%u0148ov%FDch%2C%20pojistn%FDch%20a%20dal%u0161%EDch%20z%E1kon%u016F%20-%20EU
56773,103,1352242800,94,103,0,1,198,R,Vl.n.z.%20o%20zm%u011Bn%u011B%20da%u0148ov%FDch%2C%20pojistn%FDch%20a%20dal%u0161%EDch%20z%E1kon%u016F%20-%20EU
56774,103,1352242800,104,68,22,4,198,A,Vl.n.z.%20o%20zm%u011Bn%u011B%20da%u0148ov%FDch%2C%20pojistn%FDch%20a%20dal%u0161%EDch%20z%E1kon%u016F%20-%20EU
56775,103,1352242800,197,0,1,0,198,A,Vl.n.z.%20o%20zm%u011Bn%u011B%20da%u0148ov%FDch%2C%20pojistn%FDch%20a%20dal%u0161%EDch%20z%E1kon%u016F%20-%20EU
56776,103,1352242800,93,100,4,1,198,R,Vl.n.z.%20o%20zm%u011Bn%u011B%20da%u0148ov%FDch%2C%20pojistn%FDch%20a%20dal%u0161%EDch%20z%E1kon%u016F%20-%20EU
56777,103,1352242800,195,1,1,1,198,A,Vl.n.z.%20o%20zm%u011Bn%u011B%20da%u0148ov%FDch%2C%20pojistn%FDch%20a%20dal%u0161%EDch%20z%E1kon%u016F%20-%20EU
56778,103,1352242800,95,101,2,0,198,R,Vl.n.z.%20o%20zm%u011Bn%u011B%20da%u0148ov%FDch%2C%20pojistn%FDch%20a%20dal%u0161%EDch%20z%E1kon%u016F%20-%20EU
56779,103,1352242800,97,101,0,0,198,R,Vl.n.z.%20o%20zm%u011Bn%u011B%20da%u0148ov%FDch%2C%20pojistn%FDch%20a%20dal%u0161%EDch%20z%E1kon%u016F%20-%20EU
56780,103,1352242800,94,102,0,2,198,R,Vl.n.z.%20o%20zm%u011Bn%u011B%20da%u0148ov%FDch%2C%20pojistn%FDch%20a%20dal%u0161%EDch%20z%E1kon%u016F%20-%20EU
56781,103,1352242800,117,53,25,3,198,A,Vl.n.z.%20o%20zm%u011Bn%u011B%20da%u0148ov%FDch%2C%20pojistn%FDch%20a%20dal%u0161%EDch%20z%E1kon%u016F%20-%20EU
56782,103,1352242800,115,55,23,5,198,A,Vl.n.z.%20o%20zm%u011Bn%u011B%20da%u0148ov%FDch%2C%20pojistn%FDch%20a%20dal%u0161%EDch%20z%E1kon%u016F%20-%20EU
56783,103,1352242800,2,188,3,5,198,R,Vl.n.z.%20o%20zm%u011Bn%u011B%20da%u0148ov%FDch%2C%20pojistn%FDch%20a%20dal%u0161%EDch%20z%E1kon%u016F%20-%20EU
56784,103,1352242800,2,179,7,10,198,R,Vl.n.z.%20o%20zm%u011Bn%u011B%20da%u0148ov%FDch%2C%20pojistn%FDch%20a%20dal%u0161%EDch%20z%E1kon%u016F%20-%20EU
56785,103,1352242800,93,102,0,2,197,R,Vl.n.z.%20o%20zm%u011Bn%u011B%20da%u0148ov%FDch%2C%20pojistn%FDch%20a%20dal%u0161%EDch%20z%E1kon%u016F%20-%20EU
56786,103,1352242800,197,0,0,0,197,A,Vl.n.z.%20o%20zm%u011Bn%u011B%20da%u0148ov%FDch%2C%20pojistn%FDch%20a%20dal%u0161%EDch%20z%E1kon%u016F%20-%20EU
56787,103,1352242800,93,102,1,2,198,R,Vl.n.z.%20o%20zm%u011Bn%u011B%20da%u0148ov%FDch%2C%20pojistn%FDch%20a%20dal%u0161%EDch%20z%E1kon%u016F%20-%20EU
56788,103,1352242800,116,51,24,7,198,A,Vl.n.z.%20o%20zm%u011Bn%u011B%20da%u0148ov%FDch%2C%20pojistn%FDch%20a%20dal%u0161%EDch%20z%E1kon%u016F%20-%20EU
56789,103,1352242800,100,91,4,3,198,A,Vl.n.z.%20o%20zm%u011Bn%u011B%20da%u0148ov%FDch%2C%20pojistn%FDch%20a%20dal%u0161%EDch%20z%E1kon%u016F%20-%20EU
56790,103,1352242800,190,2,4,2,198,A,Vl.n.z.%20o%20zm%u011Bn%u011B%20da%u0148ov%FDch%2C%20pojistn%FDch%20a%20dal%u0161%EDch%20z%E1kon%u016F%20-%20EU
56791,103,1352242800,102,92,2,2,198,A,Vl.n.z.%20o%20zm%u011Bn%u011B%20da%u0148ov%FDch%2C%20pojistn%FDch%20a%20dal%u0161%EDch%20z%E1kon%u016F%20-%20EU
56792,103,1352242800,101,93,0,1,195,A,Vl.n.z.%20o%20zm%u011Bn%u011B%20da%u0148ov%FDch%2C%20pojistn%FDch%20a%20dal%u0161%EDch%20z%E1kon%u016F%20-%20EU
56793,4,1352242800,104,61,24,5,194,A,Novela%20z.%20o%20soci%E1ln%u011B-pr%E1vn%ED%20ochran%u011B%20d%u011Bt%ED
56794,5,1352242800,103,89,1,0,193,A,Novela%20z.%20-%20trestn%ED%20z%E1kon%EDk
56795,6,1352242800,155,3,33,2,193,A,Vl.n.z.%20o%20pojistn%E9m%20na%20d%u016Fchodov%E9%20spo%u0159en%ED%20-%20EU
56796,6,1352242800,99,86,3,1,189,A,Vl.n.z.%20o%20pojistn%E9m%20na%20d%u016Fchodov%E9%20spo%u0159en%ED%20-%20EU
56797,6,1352242800,102,89,2,0,193,A,Vl.n.z.%20o%20pojistn%E9m%20na%20d%u016Fchodov%E9%20spo%u0159en%ED%20-%20EU
56798,7,1352242800,102,90,2,0,194,A,Vl.n.z.o%20pojistn%E9m%20na%20d%u016Fchodov%E9%20spo%u0159en%ED%20-%20souvisej%EDc%ED%20-%20EU
56799,8,1352242800,92,99,1,1,193,R,Vl.n.z.%20o%20majetkov%E9m%20vyrovn%E1n%ED%20s%20c%EDrkvemi%20a%20n%E1bo%u017Een.%20spole%u010D.
56800,8,1352242800,90,99,1,3,193,R,Vl.n.z.%20o%20majetkov%E9m%20vyrovn%E1n%ED%20s%20c%EDrkvemi%20a%20n%E1bo%u017Een.%20spole%u010D.
56801,8,1352242800,90,98,2,3,193,R,Vl.n.z.%20o%20majetkov%E9m%20vyrovn%E1n%ED%20s%20c%EDrkvemi%20a%20n%E1bo%u017Een.%20spole%u010D.
56802,8,1352329200,89,100,2,2,193,R,Vl.n.z.%20o%20majetkov%E9m%20vyrovn%E1n%ED%20s%20c%EDrkvemi%20a%20n%E1bo%u017Een.%20spole%u010D.
56803,8,1352329200,97,1,1,1,100,A,Vl.n.z.%20o%20majetkov%E9m%20vyrovn%E1n%ED%20s%20c%EDrkvemi%20a%20n%E1bo%u017Een.%20spole%u010D.
56804,8,1352329200,102,1,0,0,103,A,Vl.n.z.%20o%20majetkov%E9m%20vyrovn%E1n%ED%20s%20c%EDrkvemi%20a%20n%E1bo%u017Een.%20spole%u010D.
56805,0,1352329200,72,1,4,0,77,A,Po%u0159ad%20sch%u016Fze
56806,0,1352329200,71,0,9,0,80,A,Po%u0159ad%20sch%u016Fze
56807,0,1352329200,35,22,13,12,82,R,Po%u0159ad%20sch%u016Fze
56808,0,1352329200,41,14,16,11,82,R,Po%u0159ad%20sch%u016Fze
56809,0,1352329200,54,14,12,2,82,A,Po%u0159ad%20sch%u016Fze
56810,0,1352329200,11,7,44,4,66,R,Po%u0159ad%20sch%u016Fze
56811,0,1352329200,40,19,14,4,77,A,Po%u0159ad%20sch%u016Fze
56812,0,1352329200,62,1,15,2,80,A,Po%u0159ad%20sch%u016Fze
56813,129,1352329200,8,0,49,0,57,R,P%EDsemn%E1%20interpelace%20K.%20Kone%u010Dn%E9%20na%20T.%20Chalupu%20ve%20v%u011Bci%20postupu%20Odboru%20oc
56814,129,1352329200,82,10,15,0,107,A,P%EDsemn%E1%20interpelace%20K.%20Kone%u010Dn%E9%20na%20T.%20Chalupu%20ve%20v%u011Bci%20postupu%20Odboru%20oc
56815,129,1352329200,48,42,14,4,108,R,P%EDsemn%E1%20interpelace%20K.%20Kone%u010Dn%E9%20na%20T.%20Chalupu%20ve%20v%u011Bci%20postupu%20Odboru%20oc
56816,129,1352329200,46,43,17,2,108,R,P%EDsemn%E1%20interpelace%20M.%20V%E1ni%20na%20P.%20Ne%u010Dase%20ve%20v%u011Bci%20z%E1kona%20o%20majetkov%E9m%20v
56817,119,1352329200,80,7,20,9,116,A,Zpr%E1va%20o%20situaci%20v%20oblasti%20ve%u0159ejn%E9ho%20po%u0159%E1dku%20v%20roce%202011
56818,121,1352329200,56,10,40,14,120,R,Zpr%E1va%20o%20situaci%20v%20oblasti%20migrace%20na%20%FAzem%ED%20%u010CR%20v%20roce%202011
56819,121,1352329200,91,2,4,2,99,A,Zpr%E1va%20o%20situaci%20v%20oblasti%20migrace%20na%20%FAzem%ED%20%u010CR%20v%20roce%202011
56820,121,1352329200,52,8,24,17,101,A,Zpr%E1va%20o%20situaci%20v%20oblasti%20migrace%20na%20%FAzem%ED%20%u010CR%20v%20roce%202011
56821,94,1352329200,96,1,7,1,105,A,N%E1vrh%20na%u0159%EDzen%ED%20Rady%20-%20program%20Pericles%202020
56822,95,1352329200,93,0,14,0,107,A,Zm%u011Bny%20p%u0159%EDlohy%20III%20Rotterdamsk%E9%20%FAmluvy
56823,96,1352329200,97,0,8,1,106,A,T%u0159et%ED%20dodatkov%FD%20protokol%20k%20Evropsk%E9%20%FAmluv%u011B%20o%20vyd%E1v%E1n%ED
56824,131,1352329200,93,2,15,2,112,A,%DAml.o%20odpov%u011Bdnosti%20za%20%u0161kody%20zp%u016Fsoben%E9%20ropn%FDmi%20palivy
56825,97,1352329200,101,1,13,0,115,A,%DAml.%20Organizace%20spojen%FDch%20n%E1rod%u016F%20proti%20korupci
56826,98,1352329200,100,1,14,0,115,A,%DAml.%20o%20boji%20proti%20korupci%20%FA%u0159edn%EDk%u016F%20Evropsk%FDch%20spole%u010Denstv%ED
56827,99,1352329200,101,2,14,0,117,A,%DAml.%20o%20ochran%u011B%20finan%u010Dn%EDch%20z%E1jm%u016F%20Evropsk%FDch%20spole%u010Denstv%ED
56828,100,1352329200,91,0,25,1,117,A,Prot.mezi%20%u010CR%20a%20%u0160v%FDcarskou%20spol.radou%20o%20zamezen%ED%20dvoj.zdan%u011Bn%ED
56829,101,1352329200,95,1,21,0,117,A,Doh.%20o%20partnerstv%ED%20a%20spolupr%E1ci%20mezi%20st%E1ty%20EU%20a%20Ir%E1ckou%20rep.
56830,0,1352415600,141,4,4,3,152,A,Po%u0159ad%20sch%u016Fze
56831,0,1352415600,87,43,15,7,152,A,Po%u0159ad%20sch%u016Fze
56832,0,1352415600,124,7,20,2,153,A,Po%u0159ad%20sch%u016Fze
56833,0,1352415600,94,38,18,3,153,A,Po%u0159ad%20sch%u016Fze
56834,0,1352415600,70,52,25,6,153,R,Po%u0159ad%20sch%u016Fze
56835,0,1352415600,139,3,9,2,153,A,Po%u0159ad%20sch%u016Fze
56836,0,1352415600,77,54,19,3,153,A,Po%u0159ad%20sch%u016Fze
56837,0,1352415600,76,34,28,15,153,R,Po%u0159ad%20sch%u016Fze
56838,0,1352415600,77,44,20,12,153,A,Po%u0159ad%20sch%u016Fze
56839,0,1352415600,87,45,17,4,153,A,Po%u0159ad%20sch%u016Fze
56840,0,1352415600,126,5,20,3,154,A,Po%u0159ad%20sch%u016Fze
56841,67,1352415600,119,1,33,0,153,A,Novela%20z.%20-%20ob%u010Dansk%FD%20z%E1kon%EDk
56842,67,1352415600,121,0,31,2,154,A,Novela%20z.%20-%20ob%u010Dansk%FD%20z%E1kon%EDk
56843,67,1352415600,130,4,21,0,155,A,Novela%20z.%20-%20ob%u010Dansk%FD%20z%E1kon%EDk
56844,111,1352415600,64,75,14,1,154,R,N%E1vrh%20na%20zm%u011Bny%20ve%20slo%u017Een%ED%20org%E1n%u016F%20Poslaneck%E9%20sn%u011Bmovny
56845,111,1352415600,144,0,12,0,156,A,N%E1vrh%20na%20zm%u011Bny%20ve%20slo%u017Een%ED%20org%E1n%u016F%20Poslaneck%E9%20sn%u011Bmovny
56846,111,1352415600,73,41,13,10,137,A,N%E1vrh%20na%20zm%u011Bny%20ve%20slo%u017Een%ED%20org%E1n%u016F%20Poslaneck%E9%20sn%u011Bmovny
56847,111,1352415600,77,41,15,7,140,A,N%E1vrh%20na%20zm%u011Bny%20ve%20slo%u017Een%ED%20org%E1n%u016F%20Poslaneck%E9%20sn%u011Bmovny
56848,111,1352415600,76,47,12,6,141,A,N%E1vrh%20na%20zm%u011Bny%20ve%20slo%u017Een%ED%20org%E1n%u016F%20Poslaneck%E9%20sn%u011Bmovny
56849,111,1352415600,109,9,13,11,142,A,N%E1vrh%20na%20zm%u011Bny%20ve%20slo%u017Een%ED%20org%E1n%u016F%20Poslaneck%E9%20sn%u011Bmovny
56850,111,1352415600,124,4,13,3,144,A,N%E1vrh%20na%20zm%u011Bny%20ve%20slo%u017Een%ED%20org%E1n%u016F%20Poslaneck%E9%20sn%u011Bmovny
56851,111,1352415600,85,8,30,21,144,A,N%E1vrh%20na%20zm%u011Bny%20ve%20slo%u017Een%ED%20org%E1n%u016F%20Poslaneck%E9%20sn%u011Bmovny
56852,111,1352415600,132,0,3,2,137,A,N%E1vrh%20na%20zm%u011Bny%20ve%20slo%u017Een%ED%20org%E1n%u016F%20Poslaneck%E9%20sn%u011Bmovny
56853,111,1352415600,78,13,25,21,137,A,N%E1vrh%20na%20zm%u011Bny%20ve%20slo%u017Een%ED%20org%E1n%u016F%20Poslaneck%E9%20sn%u011Bmovny
56854,111,1352415600,123,1,6,7,137,A,N%E1vrh%20na%20zm%u011Bny%20ve%20slo%u017Een%ED%20org%E1n%u016F%20Poslaneck%E9%20sn%u011Bmovny
56855,111,1352415600,0,0,137,0,137,R,N%E1vrh%20na%20zm%u011Bny%20ve%20slo%u017Een%ED%20org%E1n%u016F%20Poslaneck%E9%20sn%u011Bmovny
56856,111,1352415600,75,23,25,14,137,A,N%E1vrh%20na%20zm%u011Bny%20ve%20slo%u017Een%ED%20org%E1n%u016F%20Poslaneck%E9%20sn%u011Bmovny
56857,111,1352415600,131,0,5,1,137,A,N%E1vrh%20na%20zm%u011Bny%20ve%20slo%u017Een%ED%20org%E1n%u016F%20Poslaneck%E9%20sn%u011Bmovny
56858,111,1352415600,131,0,5,1,137,A,N%E1vrh%20na%20zm%u011Bny%20ve%20slo%u017Een%ED%20org%E1n%u016F%20Poslaneck%E9%20sn%u011Bmovny
56859,111,1352415600,106,4,21,6,137,A,N%E1vrh%20na%20zm%u011Bny%20ve%20slo%u017Een%ED%20org%E1n%u016F%20Poslaneck%E9%20sn%u011Bmovny
56860,111,1352415600,118,2,10,7,137,A,N%E1vrh%20na%20zm%u011Bny%20ve%20slo%u017Een%ED%20org%E1n%u016F%20Poslaneck%E9%20sn%u011Bmovny
56861,111,1352415600,83,11,19,24,137,A,N%E1vrh%20na%20zm%u011Bny%20ve%20slo%u017Een%ED%20org%E1n%u016F%20Poslaneck%E9%20sn%u011Bmovny
56862,111,1352415600,133,0,3,0,136,A,N%E1vrh%20na%20zm%u011Bny%20ve%20slo%u017Een%ED%20org%E1n%u016F%20Poslaneck%E9%20sn%u011Bmovny
56863,111,1352415600,123,1,9,2,135,A,N%E1vrh%20na%20zm%u011Bny%20ve%20slo%u017Een%ED%20org%E1n%u016F%20Poslaneck%E9%20sn%u011Bmovny
56864,111,1352415600,116,1,14,5,136,A,N%E1vrh%20na%20zm%u011Bny%20ve%20slo%u017Een%ED%20org%E1n%u016F%20Poslaneck%E9%20sn%u011Bmovny
56865,111,1352415600,102,9,13,12,136,A,N%E1vrh%20na%20zm%u011Bny%20ve%20slo%u017Een%ED%20org%E1n%u016F%20Poslaneck%E9%20sn%u011Bmovny
56866,111,1352415600,124,0,10,2,136,A,N%E1vrh%20na%20zm%u011Bny%20ve%20slo%u017Een%ED%20org%E1n%u016F%20Poslaneck%E9%20sn%u011Bmovny
56867,111,1352415600,131,0,5,0,136,A,N%E1vrh%20na%20zm%u011Bny%20ve%20slo%u017Een%ED%20org%E1n%u016F%20Poslaneck%E9%20sn%u011Bmovny
56868,111,1352415600,117,4,12,2,135,A,N%E1vrh%20na%20zm%u011Bny%20ve%20slo%u017Een%ED%20org%E1n%u016F%20Poslaneck%E9%20sn%u011Bmovny
56869,111,1352415600,74,17,29,16,136,A,N%E1vrh%20na%20zm%u011Bny%20ve%20slo%u017Een%ED%20org%E1n%u016F%20Poslaneck%E9%20sn%u011Bmovny
56870,111,1352415600,134,0,2,0,136,A,N%E1vrh%20na%20zm%u011Bny%20ve%20slo%u017Een%ED%20org%E1n%u016F%20Poslaneck%E9%20sn%u011Bmovny
56871,111,1352415600,131,0,3,2,136,A,N%E1vrh%20na%20zm%u011Bny%20ve%20slo%u017Een%ED%20org%E1n%u016F%20Poslaneck%E9%20sn%u011Bmovny
56872,111,1352415600,125,0,8,3,136,A,N%E1vrh%20na%20zm%u011Bny%20ve%20slo%u017Een%ED%20org%E1n%u016F%20Poslaneck%E9%20sn%u011Bmovny
56873,111,1352415600,81,11,32,12,136,A,N%E1vrh%20na%20zm%u011Bny%20ve%20slo%u017Een%ED%20org%E1n%u016F%20Poslaneck%E9%20sn%u011Bmovny
56874,111,1352415600,114,4,13,5,136,A,N%E1vrh%20na%20zm%u011Bny%20ve%20slo%u017Een%ED%20org%E1n%u016F%20Poslaneck%E9%20sn%u011Bmovny
56875,142,1352415600,125,1,2,0,128,A,Novela%20z.%20o%20Pozemkov%E9m%20fondu%20%u010CR
56876,142,1352415600,125,1,1,1,128,A,Novela%20z.%20o%20Pozemkov%E9m%20fondu%20%u010CR
56877,142,1352415600,129,1,1,0,131,A,Novela%20z.%20o%20Pozemkov%E9m%20fondu%20%u010CR
56878,0,1352415600,104,14,7,3,128,A,%20
56879,0,1354057200,107,0,18,1,126,A,%20
56880,0,1354057200,83,24,20,21,148,A,Po%u0159ad%20sch%u016Fze
56881,1,1354057200,1,1,147,1,150,R,Vl.n.%20nov%E9ho%20z%E1kona%20o%20st%E1tn%EDm%20rozpo%u010Dtu%20%u010CR%20na%20rok%202013
56882,1,1354057200,79,72,0,1,152,A,Vl.n.%20nov%E9ho%20z%E1kona%20o%20st%E1tn%EDm%20rozpo%u010Dtu%20%u010CR%20na%20rok%202013
56883,0,1354575600,100,1,23,0,124,A,%20
56884,0,1354575600,160,1,21,0,182,A,Po%u0159ad%20sch%u016Fze
56885,0,1354575600,159,3,18,3,183,A,Po%u0159ad%20sch%u016Fze
56886,0,1354575600,122,18,21,22,183,A,Po%u0159ad%20sch%u016Fze
56887,0,1354575600,175,4,4,0,183,A,Po%u0159ad%20sch%u016Fze
56888,0,1354575600,137,12,10,24,183,A,Po%u0159ad%20sch%u016Fze
56889,0,1354575600,171,2,4,6,183,A,Po%u0159ad%20sch%u016Fze
56890,0,1354575600,87,90,5,1,183,R,Po%u0159ad%20sch%u016Fze
56891,0,1354575600,140,6,29,8,183,A,Po%u0159ad%20sch%u016Fze
56892,0,1354575600,81,87,11,4,183,R,Po%u0159ad%20sch%u016Fze
56893,0,1354575600,140,5,29,9,183,A,Po%u0159ad%20sch%u016Fze
56894,0,1354575600,0,0,183,0,183,R,Po%u0159ad%20sch%u016Fze
56895,0,1354575600,97,54,10,22,183,A,Po%u0159ad%20sch%u016Fze
56896,0,1354575600,10,123,41,9,183,R,Po%u0159ad%20sch%u016Fze
56897,0,1354575600,73,92,12,6,183,R,Po%u0159ad%20sch%u016Fze
56898,0,1354575600,81,93,8,1,183,R,Po%u0159ad%20sch%u016Fze
56899,0,1354575600,67,96,11,9,183,R,Po%u0159ad%20sch%u016Fze
56900,0,1354575600,78,91,9,5,183,R,Po%u0159ad%20sch%u016Fze
56901,0,1354575600,80,91,10,2,183,R,Po%u0159ad%20sch%u016Fze
56902,0,1354575600,64,92,24,3,183,R,Po%u0159ad%20sch%u016Fze
56903,0,1354575600,65,94,9,15,183,R,Po%u0159ad%20sch%u016Fze
56904,0,1354575600,72,88,15,8,183,R,Po%u0159ad%20sch%u016Fze
56905,0,1354575600,76,90,12,5,183,R,Po%u0159ad%20sch%u016Fze
56906,0,1354575600,60,88,31,4,183,R,Po%u0159ad%20sch%u016Fze
56907,0,1354575600,79,84,10,10,183,R,Po%u0159ad%20sch%u016Fze
56908,0,1354575600,83,93,7,0,183,R,Po%u0159ad%20sch%u016Fze
56909,0,1354575600,113,29,18,23,183,A,Po%u0159ad%20sch%u016Fze
56910,0,1354575600,115,13,34,21,183,A,Po%u0159ad%20sch%u016Fze
56911,0,1354575600,89,90,4,0,183,R,Po%u0159ad%20sch%u016Fze
56912,0,1354575600,83,88,7,5,183,R,Po%u0159ad%20sch%u016Fze
56913,0,1354575600,49,105,12,17,183,R,Po%u0159ad%20sch%u016Fze
56914,0,1354575600,96,78,6,2,182,A,Po%u0159ad%20sch%u016Fze
56915,0,1354575600,169,4,8,1,182,A,Po%u0159ad%20sch%u016Fze
56916,0,1354575600,157,2,22,1,182,A,Po%u0159ad%20sch%u016Fze
56917,0,1354575600,12,2,165,2,181,R,Po%u0159ad%20sch%u016Fze
56918,0,1354575600,122,14,18,25,179,A,Po%u0159ad%20sch%u016Fze
56919,0,1354575600,92,80,3,2,177,A,Po%u0159ad%20sch%u016Fze
56920,132,1354575600,158,0,1,2,161,A,%u017D%E1dost%20k%20trestn%EDmu%20st%EDh%E1n%ED%20poslance%20Romana%20Pek%E1rka
56921,6,1354575600,142,0,21,0,163,A,Vl.n.z.%20o%20zru%u0161en%ED%20z%E1kona%20o%20%FArazov%E9m%20poji%u0161t%u011Bn%ED%20zam%u011Bstnanc%u016F
56922,6,1354575600,151,0,1,2,154,A,Vl.n.z.%20o%20zru%u0161en%ED%20z%E1kona%20o%20%FArazov%E9m%20poji%u0161t%u011Bn%ED%20zam%u011Bstnanc%u016F
56923,80,1354575600,135,0,23,0,158,A,Vl.n.z.%20o%20st%E1tn%EDm%20ob%u010Danstv%ED%20%u010Cesk%E9%20republiky
56924,80,1354575600,125,9,24,1,159,A,Vl.n.z.%20o%20st%E1tn%EDm%20ob%u010Danstv%ED%20%u010Cesk%E9%20republiky
56925,72,1354575600,120,0,34,0,154,A,Novela%20z.%20o%20obecn%ED%20policii
56926,72,1354575600,130,0,1,0,131,A,Novela%20z.%20o%20obecn%ED%20policii
56927,72,1354575600,113,13,3,2,131,A,Novela%20z.%20o%20obecn%ED%20policii
56928,9,1354575600,103,2,2,3,110,A,N.z.%20o%20ob%u011Btech%20trestn%FDch%20%u010Din%u016F%20-%20EU
56929,10,1354575600,103,1,4,1,109,A,Novela%20z.%20o%20integrovan%E9%20prevenci%20-%20EU
56930,13,1354575600,63,38,9,7,117,A,Novela%20z.%20-%20tiskov%FD%20z%E1kon
56931,91,1354748400,97,0,12,0,109,A,Prot.mezi%20%u010CR%20a%20vl.St%E1tu%20Izrael%20o%20leteck%E9%20doprav%u011B
56932,92,1354748400,101,0,17,0,118,A,Sml.%20mezi%20%u010CR%20a%20Rep.%20Makedonie%20o%20mezin%E1rodn%ED%20silni%u010Dn%ED%20doprav%u011B
56933,93,1354748400,92,0,25,5,122,A,Zm%u011Bny%20Dohody%20o%20Mezin%E1rodn%EDm%20m%u011Bnov%E9m%20fondu
56934,94,1354748400,107,0,16,0,123,A,Sml.%20o%20spolupr%E1ci%20v%20oblasti%20ochrany%20sv%u011Bdk%u016F
56935,95,1354748400,108,0,15,0,123,A,Sml.mezi%20%u010CR%20a%20%u010Cernou%20Horou%20o%20spol.%20v%20boji%20proti%20tr.%u010Dinnosti
56936,96,1354748400,111,0,15,0,126,A,Doh.%20o%20leteck%E9%20doprav%u011B
56937,97,1354748400,116,0,13,0,129,A,Zm%u011Bny%20%DAstavy%20a%20%DAmluvy%20Mezin%E1rodn%ED%20telekomunika%u010Dn%ED%20unie
56938,98,1354748400,114,0,16,1,131,A,Sml.mezi%20%u010CR%20a%20Ma%u010Farskem%20o%20ochran%u011B%20utaj.informac%ED
56939,99,1354748400,113,0,21,0,134,A,Sml.%20mezi%20%u010CR%20a%20Panamskou%20rep.%20o%20zamezen%ED%20dvoj%EDmu%20zdan%u011Bn%ED
56940,100,1354748400,113,0,21,0,134,A,Sml.mezi%20%u010CR%20a%20Polskou%20rep.%20o%20spole%u010Dn%FDch%20st%E1tn%EDch%20hranic%EDch
56941,101,1354748400,28,0,105,0,133,R,Dohoda%20o%20spol.%20leteck%E9m%20prostoru%20mezi%20EU%20a%20Moldavskou%20rep.
56942,101,1354748400,114,0,18,1,133,A,Dohoda%20o%20spol.%20leteck%E9m%20prostoru%20mezi%20EU%20a%20Moldavskou%20rep.
56943,102,1354748400,117,0,16,0,133,A,Prot.%20mezi%20%u010CR%20a%20Nizozemsk%FDm%20kr%E1l.%20o%20zamezen%ED%20dvoj%EDho%20zdan%u011Bn%ED
56944,0,1354834800,77,40,26,4,147,A,Po%u0159ad%20sch%u016Fze
56945,114,1354834800,152,0,11,1,164,A,Novela%20z.%20o%20podpo%u0159e%20v%FDzkumu%20a%20v%FDvoje
56946,114,1354834800,160,0,5,0,165,A,Novela%20z.%20o%20podpo%u0159e%20v%FDzkumu%20a%20v%FDvoje
56947,114,1354834800,74,70,12,9,165,R,Novela%20z.%20o%20podpo%u0159e%20v%FDzkumu%20a%20v%FDvoje
56948,114,1354834800,162,0,5,0,167,A,Novela%20z.%20o%20podpo%u0159e%20v%FDzkumu%20a%20v%FDvoje
56949,114,1354834800,165,0,5,0,170,A,Novela%20z.%20o%20podpo%u0159e%20v%FDzkumu%20a%20v%FDvoje
56950,108,1354834800,160,1,10,0,171,A,Novela%20z.%20o%20finan%u010Dn%ED%20kontrole%20-%20EU
56951,108,1354834800,74,85,4,6,169,R,Novela%20z.%20o%20finan%u010Dn%ED%20kontrole%20-%20EU
56952,108,1354834800,165,0,4,0,169,A,Novela%20z.%20o%20finan%u010Dn%ED%20kontrole%20-%20EU
56953,108,1354834800,162,0,6,0,168,A,Novela%20z.%20o%20finan%u010Dn%ED%20kontrole%20-%20EU
56954,108,1354834800,99,36,25,9,169,A,Novela%20z.%20o%20finan%u010Dn%ED%20kontrole%20-%20EU
56955,108,1354834800,86,56,23,3,168,A,Novela%20z.%20o%20finan%u010Dn%ED%20kontrole%20-%20EU
56956,109,1354834800,73,80,12,2,167,R,Novela%20z.%20o%20spot%u0159ebitelsk%E9m%20%FAv%u011Bru%20-%20EU
56957,109,1354834800,83,73,2,4,162,A,Novela%20z.%20o%20spot%u0159ebitelsk%E9m%20%FAv%u011Bru%20-%20EU
56958,109,1354834800,69,92,1,1,163,R,Novela%20z.%20o%20spot%u0159ebitelsk%E9m%20%FAv%u011Bru%20-%20EU
56959,109,1354834800,74,84,4,0,162,R,Novela%20z.%20o%20spot%u0159ebitelsk%E9m%20%FAv%u011Bru%20-%20EU
56960,109,1354834800,76,82,3,2,163,R,Novela%20z.%20o%20spot%u0159ebitelsk%E9m%20%FAv%u011Bru%20-%20EU
56961,109,1354834800,117,15,12,21,165,A,Novela%20z.%20o%20spot%u0159ebitelsk%E9m%20%FAv%u011Bru%20-%20EU
56962,109,1354834800,163,0,0,1,164,A,Novela%20z.%20o%20spot%u0159ebitelsk%E9m%20%FAv%u011Bru%20-%20EU
56963,110,1354834800,24,94,29,14,161,R,Novela%20z.%20o%20Nejvy%u0161%u0161%EDm%20kontroln%EDm%20%FA%u0159adu
56964,110,1354834800,143,10,8,0,161,A,Novela%20z.%20o%20Nejvy%u0161%u0161%EDm%20kontroln%EDm%20%FA%u0159adu
56965,110,1354834800,120,10,26,4,160,A,Novela%20z.%20o%20Nejvy%u0161%u0161%EDm%20kontroln%EDm%20%FA%u0159adu
56966,110,1354834800,153,0,8,0,161,A,Novela%20z.%20o%20Nejvy%u0161%u0161%EDm%20kontroln%EDm%20%FA%u0159adu
56967,110,1354834800,153,0,7,1,161,A,Novela%20z.%20o%20Nejvy%u0161%u0161%EDm%20kontroln%EDm%20%FA%u0159adu
56968,110,1354834800,156,0,5,0,161,A,Novela%20z.%20o%20Nejvy%u0161%u0161%EDm%20kontroln%EDm%20%FA%u0159adu
56969,110,1354834800,152,1,6,2,161,A,Novela%20z.%20o%20Nejvy%u0161%u0161%EDm%20kontroln%EDm%20%FA%u0159adu
56970,110,1354834800,71,79,5,5,160,R,Novela%20z.%20o%20Nejvy%u0161%u0161%EDm%20kontroln%EDm%20%FA%u0159adu
56971,110,1354834800,33,112,9,7,161,R,Novela%20z.%20o%20Nejvy%u0161%u0161%EDm%20kontroln%EDm%20%FA%u0159adu
56972,110,1354834800,64,90,4,2,160,R,Novela%20z.%20o%20Nejvy%u0161%u0161%EDm%20kontroln%EDm%20%FA%u0159adu
56973,110,1354834800,153,1,6,1,161,A,Novela%20z.%20o%20Nejvy%u0161%u0161%EDm%20kontroln%EDm%20%FA%u0159adu
56974,110,1354834800,154,0,4,3,161,A,Novela%20z.%20o%20Nejvy%u0161%u0161%EDm%20kontroln%EDm%20%FA%u0159adu
56975,110,1354834800,143,8,7,3,161,A,Novela%20z.%20o%20Nejvy%u0161%u0161%EDm%20kontroln%EDm%20%FA%u0159adu
56976,110,1354834800,66,87,5,2,160,R,Novela%20z.%20o%20Nejvy%u0161%u0161%EDm%20kontroln%EDm%20%FA%u0159adu
56977,110,1354834800,67,88,5,1,161,R,Novela%20z.%20o%20Nejvy%u0161%u0161%EDm%20kontroln%EDm%20%FA%u0159adu
56978,110,1354834800,150,3,6,2,161,A,Novela%20z.%20o%20Nejvy%u0161%u0161%EDm%20kontroln%EDm%20%FA%u0159adu
56979,111,1354834800,144,0,2,3,149,A,Novela%20z.%20o%20l%E9%u010Divech
56980,111,1354834800,7,0,143,0,150,R,Novela%20z.%20o%20l%E9%u010Divech
56981,111,1354834800,142,0,4,5,151,A,Novela%20z.%20o%20l%E9%u010Divech
56982,111,1354834800,137,0,5,9,151,A,Novela%20z.%20o%20l%E9%u010Divech
56983,111,1354834800,150,1,1,0,152,A,Novela%20z.%20o%20l%E9%u010Divech
56984,111,1354834800,150,0,4,0,154,A,Novela%20z.%20o%20l%E9%u010Divech
56985,111,1354834800,126,7,13,8,154,A,Novela%20z.%20o%20l%E9%u010Divech
56986,112,1354834800,69,77,0,2,148,R,Novela%20z.%20o%20pojistn%E9m%20na%20v%u0161eobecn%E9%20zdravotn%ED%20poji%u0161t%u011Bn%ED
56987,113,1354834800,83,11,32,24,150,A,N.z.o%20zm%u011Bn%u011B%20pr%E1vn%ED%20formy%20ob%u010Dansk%E9ho%20sdru%u017Een%ED
56988,18,1354834800,85,12,9,9,115,A,Novela%20z.%20o%20platu%20p%u0159edstavitel%u016F%20st%E1tn%ED%20moci
56989,0,1355180400,76,75,14,4,169,R,Po%u0159ad%20sch%u016Fze
56990,0,1355180400,87,39,27,16,169,A,Po%u0159ad%20sch%u016Fze
56991,0,1355180400,131,15,19,3,168,A,Po%u0159ad%20sch%u016Fze
56992,0,1355180400,124,11,27,5,167,A,Po%u0159ad%20sch%u016Fze
56993,0,1355180400,125,10,29,4,168,A,Po%u0159ad%20sch%u016Fze
56994,0,1355180400,95,24,28,22,169,A,Po%u0159ad%20sch%u016Fze
56995,0,1355180400,96,29,28,19,172,A,Po%u0159ad%20sch%u016Fze
56996,0,1355180400,96,31,27,17,171,A,Po%u0159ad%20sch%u016Fze
56997,0,1355180400,74,67,19,12,172,R,Po%u0159ad%20sch%u016Fze
56998,0,1355180400,131,8,29,4,172,A,Po%u0159ad%20sch%u016Fze
56999,0,1355180400,79,76,15,2,172,R,Po%u0159ad%20sch%u016Fze
57000,0,1355180400,80,75,15,2,172,R,Po%u0159ad%20sch%u016Fze
57001,0,1355180400,71,73,26,3,173,R,Po%u0159ad%20sch%u016Fze
57002,0,1355180400,75,66,28,4,173,R,Po%u0159ad%20sch%u016Fze
57003,0,1355180400,77,75,17,3,172,R,Po%u0159ad%20sch%u016Fze
57004,0,1355180400,65,81,20,6,172,R,Po%u0159ad%20sch%u016Fze
57005,0,1355180400,159,5,5,2,171,A,Po%u0159ad%20sch%u016Fze
57006,25,1355180400,121,0,41,2,164,A,Novela%20z.%20o%20elektronick%FDch%20komunikac%EDch%20-%20EU
57007,26,1355180400,135,0,34,0,169,A,Novela%20z.%20o%20nouzov%FDch%20z%E1sob%E1ch%20ropy%20-%20EU
57008,31,1355180400,123,0,45,0,168,A,Novela%20z.%20o%20technick%FDch%20po%u017Eadavc%EDch%20na%20v%FDrobky%20-%20EU
57009,31,1355180400,89,6,63,10,168,A,Novela%20z.%20o%20technick%FDch%20po%u017Eadavc%EDch%20na%20v%FDrobky%20-%20EU
57010,150,1355180400,89,18,7,23,137,A,Zpr%E1va%20o%20v%FDvoji%20mal%E9ho%20a%20st%u0159edn%EDho%20podnik%E1n%ED%20v%20roce%202011
57011,37,1355180400,116,0,28,0,144,A,Novela%20z.%20o%20st%u0159eln%FDch%20zbran%EDch%20-%20EU
57012,37,1355180400,85,27,31,4,147,A,Novela%20z.%20o%20st%u0159eln%FDch%20zbran%EDch%20-%20EU
57013,33,1355180400,113,0,38,0,151,A,Novela%20z.%20o%20azylu%20a%20Policii%20%u010CR%20-%20EU
57014,82,1355180400,116,1,36,0,153,A,Novela%20z.%20o%20cestovn%EDch%20dokladech
57015,9,1355180400,80,8,51,13,152,A,N.z.%20o%20ob%u011Btech%20trestn%FDch%20%u010Din%u016F%20-%20EU
57016,88,1355180400,107,1,44,2,154,A,Novela%20z.%20o%20ve%u0159ejn%E9m%20zdravotn%EDm%20poji%u0161t%u011Bn%ED
57017,88,1355180400,73,52,1,4,130,A,Novela%20z.%20o%20ve%u0159ejn%E9m%20zdravotn%EDm%20poji%u0161t%u011Bn%ED
57018,12,1355180400,62,15,52,11,140,R,Novela%20z.%20-%20transplanta%u010Dn%ED%20z%E1kon%20-%20EU
57019,11,1355180400,70,26,5,8,109,A,Novela%20z.%20o%20l%E9%u010Divech%20-%20EU
57020,16,1355180400,65,18,15,8,106,A,Novela%20z.%20o%20zdravotn%EDch%20slu%u017Eb%E1ch
57021,17,1355180400,97,0,3,1,101,A,Novela%20z.%20o%20specifick%FDch%20zdravotn%EDch%20slu%u017Eb%E1ch
57022,0,1355266800,114,0,14,0,128,A,Po%u0159ad%20sch%u016Fze
57023,0,1355266800,89,21,27,2,139,A,Po%u0159ad%20sch%u016Fze
57024,0,1355266800,141,1,4,0,146,A,Po%u0159ad%20sch%u016Fze
57025,0,1355266800,139,2,4,1,146,A,Po%u0159ad%20sch%u016Fze
57026,0,1355266800,88,18,30,12,148,A,Po%u0159ad%20sch%u016Fze
57027,0,1355266800,96,12,30,15,153,A,Po%u0159ad%20sch%u016Fze
57028,125,1355266800,50,63,38,21,172,R,Novela%20z.%20o%20platu%20p%u0159edstavitel%u016F%20st%E1tn%ED%20moci
57029,125,1355266800,125,19,21,8,173,A,Novela%20z.%20o%20platu%20p%u0159edstavitel%u016F%20st%E1tn%ED%20moci
57030,125,1355266800,100,3,34,31,168,A,Novela%20z.%20o%20platu%20p%u0159edstavitel%u016F%20st%E1tn%ED%20moci
57031,125,1355266800,68,46,27,27,168,R,Novela%20z.%20o%20platu%20p%u0159edstavitel%u016F%20st%E1tn%ED%20moci
57032,125,1355266800,17,55,46,50,168,R,Novela%20z.%20o%20platu%20p%u0159edstavitel%u016F%20st%E1tn%ED%20moci
57033,125,1355266800,43,64,37,22,166,R,Novela%20z.%20o%20platu%20p%u0159edstavitel%u016F%20st%E1tn%ED%20moci
57034,125,1355266800,37,67,41,23,168,R,Novela%20z.%20o%20platu%20p%u0159edstavitel%u016F%20st%E1tn%ED%20moci
57035,125,1355266800,29,59,44,36,168,R,Novela%20z.%20o%20platu%20p%u0159edstavitel%u016F%20st%E1tn%ED%20moci
57036,125,1355266800,83,34,21,17,155,A,Novela%20z.%20o%20platu%20p%u0159edstavitel%u016F%20st%E1tn%ED%20moci
57037,125,1355266800,66,44,26,17,153,R,Novela%20z.%20o%20platu%20p%u0159edstavitel%u016F%20st%E1tn%ED%20moci
57038,125,1355266800,147,8,9,2,166,A,Novela%20z.%20o%20platu%20p%u0159edstavitel%u016F%20st%E1tn%ED%20moci
57039,125,1355266800,69,42,21,14,146,R,Novela%20z.%20o%20platu%20p%u0159edstavitel%u016F%20st%E1tn%ED%20moci
57040,160,1355266800,102,0,54,0,156,A,N%E1vrh%20na%20potvrzen%ED%20p%u0159edsedkyn%u011B%20peti%u010Dn%EDho%20v%FDboru
57041,158,1355266800,85,18,16,9,128,A,N%E1vrh%20na%20zm%u011Bnu%20usnesen%ED%20PS%20%u010D.%206%20ze%20dne%2024.%20%u010Dervna%202010
57042,28,1355266800,114,1,18,6,139,A,Novela%20z.%20-%20obchodn%ED%20z%E1kon%EDk%20-%20EU
57043,55,1355266800,124,0,31,1,156,A,Novela%20z.%20o%20insolven%u010Dn%EDch%20spr%E1vc%EDch
57044,63,1355266800,122,0,34,0,156,A,Novela%20z.%20o%20V%u011Bze%u0148sk%E9%20slu%u017Eb%u011B%20a%20justi%u010Dn%ED%20str%E1%u017Ei%20%u010CR
57045,63,1355266800,125,1,32,1,159,A,Novela%20z.%20o%20V%u011Bze%u0148sk%E9%20slu%u017Eb%u011B%20a%20justi%u010Dn%ED%20str%E1%u017Ei%20%u010CR
57046,79,1355266800,126,0,32,1,159,A,Novela%20z.o%20vy%u0161%u0161%EDch%20soud.%FA%u0159edn%EDc%EDch%20a%20vy%u0161%u0161%EDch%20%FA%u0159ed.st%E1t.zast.
57047,70,1355266800,120,1,35,1,157,A,Novela%20z.%20-%20autorsk%FD%20z%E1kon
57048,70,1355266800,102,2,51,4,159,A,Novela%20z.%20-%20autorsk%FD%20z%E1kon
57049,70,1355266800,61,27,65,7,160,R,Novela%20z.%20-%20autorsk%FD%20z%E1kon
57050,70,1355266800,109,13,38,2,162,A,Novela%20z.%20-%20autorsk%FD%20z%E1kon
57051,70,1355266800,80,36,19,7,142,A,Novela%20z.%20-%20autorsk%FD%20z%E1kon
57052,0,1355353200,61,40,10,6,117,A,Po%u0159ad%20sch%u016Fze
57053,0,1355353200,76,21,14,7,118,A,Po%u0159ad%20sch%u016Fze
57054,0,1355353200,65,43,8,9,125,A,Po%u0159ad%20sch%u016Fze
57055,0,1355353200,119,0,3,2,124,A,Po%u0159ad%20sch%u016Fze
57056,0,1355353200,71,42,9,2,124,A,Po%u0159ad%20sch%u016Fze
57057,0,1355353200,120,3,2,0,125,A,Po%u0159ad%20sch%u016Fze
57058,0,1355353200,60,59,6,1,126,R,Po%u0159ad%20sch%u016Fze
57059,0,1355353200,63,52,7,5,127,R,Po%u0159ad%20sch%u016Fze
57060,0,1355353200,115,6,6,0,127,A,Po%u0159ad%20sch%u016Fze
57061,0,1355353200,64,60,0,3,127,A,Po%u0159ad%20sch%u016Fze
57062,151,1355353200,69,29,13,19,130,A,Zpr.%20o%20vyu%u017Eit%ED%20doporu%u010Den%ED%20ve%u0159ejn%E9ho%20ochr%E1nce%20pr%E1v
57063,161,1355353200,69,58,5,2,134,A,Informace%20ministra%20financ%ED%20o%20nehor%E1zn%u011B%20vysok%FDch%20platech%20%FA%u0159edn%EDk%u016F
57064,162,1355353200,66,42,11,5,124,A,Informace%20o%20zp%u016Fsobu%20%u0159e%u0161en%ED%20v%FDplat%20podpor%20v%20nezam%u011Bstnanosti
57065,131,1355353200,98,4,3,1,106,A,N%E1vrh%20na%20zm%u011Bny%20zasedac%EDho%20po%u0159%E1dku%20PS
57066,131,1355353200,43,49,7,7,106,R,N%E1vrh%20na%20zm%u011Bny%20zasedac%EDho%20po%u0159%E1dku%20PS
57067,131,1355353200,105,1,0,0,106,A,N%E1vrh%20na%20zm%u011Bny%20zasedac%EDho%20po%u0159%E1dku%20PS
57068,131,1355353200,79,19,4,6,108,A,N%E1vrh%20na%20zm%u011Bny%20zasedac%EDho%20po%u0159%E1dku%20PS
57069,131,1355353200,59,45,3,2,109,A,N%E1vrh%20na%20zm%u011Bny%20zasedac%EDho%20po%u0159%E1dku%20PS
57070,131,1355353200,93,6,8,2,109,A,N%E1vrh%20na%20zm%u011Bny%20zasedac%EDho%20po%u0159%E1dku%20PS
57071,0,1355439600,77,36,14,23,150,A,Po%u0159ad%20sch%u016Fze
57072,0,1355439600,103,14,31,4,152,A,Po%u0159ad%20sch%u016Fze
57073,0,1355439600,77,39,11,24,151,A,Po%u0159ad%20sch%u016Fze
57074,0,1355439600,90,16,26,20,152,A,Po%u0159ad%20sch%u016Fze
57075,0,1355439600,77,23,41,13,154,R,Po%u0159ad%20sch%u016Fze
57076,0,1355439600,130,12,11,2,155,A,Po%u0159ad%20sch%u016Fze
57077,0,1355439600,12,3,120,0,135,R,Po%u0159ad%20sch%u016Fze
57078,0,1355439600,126,0,20,5,151,A,Po%u0159ad%20sch%u016Fze
57079,0,1355439600,79,44,29,2,154,A,Po%u0159ad%20sch%u016Fze
57080,0,1355439600,87,19,34,14,154,A,Po%u0159ad%20sch%u016Fze
57081,0,1355439600,119,3,28,4,154,A,Po%u0159ad%20sch%u016Fze
57082,0,1355439600,87,35,26,7,155,A,Po%u0159ad%20sch%u016Fze
57083,0,1355439600,89,35,24,7,155,A,Po%u0159ad%20sch%u016Fze
57084,163,1355439600,73,71,3,5,152,R,Informace%20ministryn%u011B%20obrany%20o%20zm%u011Bn%E1ch%20na%20ministerstvu%20obrany
57085,163,1355439600,73,72,2,5,152,R,Informace%20ministryn%u011B%20obrany%20o%20zm%u011Bn%E1ch%20na%20ministerstvu%20obrany
57086,118,1355439600,141,1,9,0,151,A,Novela%20z.%20o%20l%E9%u010Divech%20-%20EU
57087,118,1355439600,138,0,6,3,147,A,Novela%20z.%20o%20l%E9%u010Divech%20-%20EU
57088,118,1355439600,146,0,5,0,151,A,Novela%20z.%20o%20l%E9%u010Divech%20-%20EU
57089,118,1355439600,144,0,5,2,151,A,Novela%20z.%20o%20l%E9%u010Divech%20-%20EU
57090,118,1355439600,138,1,7,5,151,A,Novela%20z.%20o%20l%E9%u010Divech%20-%20EU
57091,118,1355439600,142,1,8,1,152,A,Novela%20z.%20o%20l%E9%u010Divech%20-%20EU
57092,118,1355439600,144,0,6,1,151,A,Novela%20z.%20o%20l%E9%u010Divech%20-%20EU
57093,118,1355439600,102,19,14,17,152,A,Novela%20z.%20o%20l%E9%u010Divech%20-%20EU
57094,118,1355439600,141,2,6,4,153,A,Novela%20z.%20o%20l%E9%u010Divech%20-%20EU
57095,123,1355439600,143,1,5,2,151,A,Novela%20z.%20o%20zdravotn%EDch%20slu%u017Eb%E1ch
57096,123,1355439600,135,4,10,2,151,A,Novela%20z.%20o%20zdravotn%EDch%20slu%u017Eb%E1ch
57097,123,1355439600,141,0,7,3,151,A,Novela%20z.%20o%20zdravotn%EDch%20slu%u017Eb%E1ch
57098,124,1355439600,142,1,8,0,151,A,Novela%20z.%20o%20specifick%FDch%20zdravotn%EDch%20slu%u017Eb%E1ch
57099,124,1355439600,144,0,7,0,151,A,Novela%20z.%20o%20specifick%FDch%20zdravotn%EDch%20slu%u017Eb%E1ch
57100,121,1355439600,2,0,146,1,149,R,Novela%20z.%20o%20vysok%FDch%20%u0161kol%E1ch
57101,121,1355439600,137,0,11,2,150,A,Novela%20z.%20o%20vysok%FDch%20%u0161kol%E1ch
57102,121,1355439600,143,0,7,0,150,A,Novela%20z.%20o%20vysok%FDch%20%u0161kol%E1ch
57103,121,1355439600,142,0,8,0,150,A,Novela%20z.%20o%20vysok%FDch%20%u0161kol%E1ch
57104,121,1355439600,63,77,7,3,150,R,Novela%20z.%20o%20vysok%FDch%20%u0161kol%E1ch
57105,121,1355439600,143,1,6,0,150,A,Novela%20z.%20o%20vysok%FDch%20%u0161kol%E1ch
57106,122,1355439600,135,0,15,1,151,A,Vl.n.z.%2Ckter%FDm%20se%20upravuj%ED%20ot%E1zky%20souvis.%20s%20u%u017E%EDv%E1n%EDm%20byt%u016F
57107,122,1355439600,135,0,15,1,151,A,Vl.n.z.%2Ckter%FDm%20se%20upravuj%ED%20ot%E1zky%20souvis.%20s%20u%u017E%EDv%E1n%EDm%20byt%u016F
57108,122,1355439600,64,70,18,0,152,R,Vl.n.z.%2Ckter%FDm%20se%20upravuj%ED%20ot%E1zky%20souvis.%20s%20u%u017E%EDv%E1n%EDm%20byt%u016F
57109,122,1355439600,64,73,13,1,151,R,Vl.n.z.%2Ckter%FDm%20se%20upravuj%ED%20ot%E1zky%20souvis.%20s%20u%u017E%EDv%E1n%EDm%20byt%u016F
57110,122,1355439600,64,75,12,0,151,R,Vl.n.z.%2Ckter%FDm%20se%20upravuj%ED%20ot%E1zky%20souvis.%20s%20u%u017E%EDv%E1n%EDm%20byt%u016F
57111,122,1355439600,63,73,14,1,151,R,Vl.n.z.%2Ckter%FDm%20se%20upravuj%ED%20ot%E1zky%20souvis.%20s%20u%u017E%EDv%E1n%EDm%20byt%u016F
57112,122,1355439600,133,1,12,4,150,A,Vl.n.z.%2Ckter%FDm%20se%20upravuj%ED%20ot%E1zky%20souvis.%20s%20u%u017E%EDv%E1n%EDm%20byt%u016F
57113,9,1355439600,102,13,26,3,144,A,N.z.%20o%20ob%u011Btech%20trestn%FDch%20%u010Din%u016F%20-%20EU
57114,0,1355785200,95,11,29,24,159,A,%20
57115,0,1355785200,122,12,14,17,165,A,Po%u0159ad%20sch%u016Fze
57116,0,1355785200,99,13,32,23,167,A,Po%u0159ad%20sch%u016Fze
57117,0,1355785200,47,19,95,2,163,R,%20
57118,0,1355785200,82,44,20,5,151,A,%20
57119,0,1355785200,68,62,4,13,147,R,Po%u0159ad%20sch%u016Fze
57120,0,1355785200,79,82,5,2,168,R,Po%u0159ad%20sch%u016Fze
57121,0,1355785200,90,28,27,24,169,A,Po%u0159ad%20sch%u016Fze
57122,0,1355785200,133,8,24,4,169,A,Po%u0159ad%20sch%u016Fze
57123,164,1355785200,160,3,2,3,168,A,Novela%20z.%20o%20platu%20p%u0159edstavitel%u016F%20st%E1tn%ED%20moci
57124,164,1355785200,133,2,21,5,161,A,Novela%20z.%20o%20platu%20p%u0159edstavitel%u016F%20st%E1tn%ED%20moci
57125,164,1355785200,69,21,4,0,94,A,Novela%20z.%20o%20platu%20p%u0159edstavitel%u016F%20st%E1tn%ED%20moci
57126,164,1355785200,24,32,15,35,106,R,Novela%20z.%20o%20platu%20p%u0159edstavitel%u016F%20st%E1tn%ED%20moci
57127,164,1355785200,80,8,9,2,99,A,Novela%20z.%20o%20platu%20p%u0159edstavitel%u016F%20st%E1tn%ED%20moci
57128,165,1355785200,120,2,15,30,167,A,Novela%20z.%20o%20soci%E1ln%u011B-pr%E1vn%ED%20ochran%u011B%20d%u011Bt%ED
57129,165,1355785200,109,21,9,15,154,A,Novela%20z.%20o%20soci%E1ln%u011B-pr%E1vn%ED%20ochran%u011B%20d%u011Bt%ED
57130,165,1355785200,106,9,17,22,154,A,Novela%20z.%20o%20soci%E1ln%u011B-pr%E1vn%ED%20ochran%u011B%20d%u011Bt%ED
57131,3,1355785200,141,1,8,1,151,A,Vl.n.z.%20o%20audiovizi
57132,5,1355785200,134,1,15,2,152,A,Novela%20z.%20o%20rozpo%u010Dtov%FDch%20pravidlech
57133,5,1355785200,97,6,24,20,147,A,Novela%20z.%20o%20rozpo%u010Dtov%FDch%20pravidlech
57134,119,1355785200,135,0,5,0,140,A,Novela%20z.%20-%20transplanta%u010Dn%ED%20z%E1kon%20-%20EU
57135,119,1355785200,56,77,7,0,140,R,Novela%20z.%20-%20transplanta%u010Dn%ED%20z%E1kon%20-%20EU
57136,119,1355785200,135,0,5,0,140,A,Novela%20z.%20-%20transplanta%u010Dn%ED%20z%E1kon%20-%20EU
57137,119,1355785200,133,0,7,0,140,A,Novela%20z.%20-%20transplanta%u010Dn%ED%20z%E1kon%20-%20EU
57138,119,1355785200,53,77,7,3,140,R,Novela%20z.%20-%20transplanta%u010Dn%ED%20z%E1kon%20-%20EU
57139,119,1355785200,134,0,6,0,140,A,Novela%20z.%20-%20transplanta%u010Dn%ED%20z%E1kon%20-%20EU
57140,119,1355785200,57,67,6,10,140,R,Novela%20z.%20-%20transplanta%u010Dn%ED%20z%E1kon%20-%20EU
57141,119,1355785200,138,0,2,0,140,A,Novela%20z.%20-%20transplanta%u010Dn%ED%20z%E1kon%20-%20EU
57142,119,1355785200,83,47,9,1,140,A,Novela%20z.%20-%20transplanta%u010Dn%ED%20z%E1kon%20-%20EU
57143,119,1355785200,134,1,5,0,140,A,Novela%20z.%20-%20transplanta%u010Dn%ED%20z%E1kon%20-%20EU
57144,119,1355785200,54,73,9,4,140,R,Novela%20z.%20-%20transplanta%u010Dn%ED%20z%E1kon%20-%20EU
57145,119,1355785200,136,1,3,0,140,A,Novela%20z.%20-%20transplanta%u010Dn%ED%20z%E1kon%20-%20EU
57146,119,1355785200,139,0,2,0,141,A,Novela%20z.%20-%20transplanta%u010Dn%ED%20z%E1kon%20-%20EU
57147,115,1355785200,130,0,9,0,139,A,N.z.%20o%20ob%u011Btech%20trestn%FDch%20%u010Din%u016F%20-%20EU
57148,115,1355785200,102,17,18,2,139,A,N.z.%20o%20ob%u011Btech%20trestn%FDch%20%u010Din%u016F%20-%20EU
57149,115,1355785200,128,0,10,1,139,A,N.z.%20o%20ob%u011Btech%20trestn%FDch%20%u010Din%u016F%20-%20EU
57150,115,1355785200,110,14,14,1,139,A,N.z.%20o%20ob%u011Btech%20trestn%FDch%20%u010Din%u016F%20-%20EU
57151,115,1355785200,130,1,7,1,139,A,N.z.%20o%20ob%u011Btech%20trestn%FDch%20%u010Din%u016F%20-%20EU
57152,117,1355785200,125,0,12,1,138,A,Novela%20z.%20o%20integrovan%E9%20prevenci%20-%20EU
57153,117,1355785200,22,69,31,14,136,R,Novela%20z.%20o%20integrovan%E9%20prevenci%20-%20EU
57154,117,1355785200,123,0,13,1,137,A,Novela%20z.%20o%20integrovan%E9%20prevenci%20-%20EU
57155,117,1355785200,130,0,6,1,137,A,Novela%20z.%20o%20integrovan%E9%20prevenci%20-%20EU
57156,0,1355871600,80,55,16,20,171,R,Po%u0159ad%20sch%u016Fze
57157,0,1355871600,164,2,10,0,176,A,Po%u0159ad%20sch%u016Fze
57158,0,1355871600,82,56,12,22,172,R,Po%u0159ad%20sch%u016Fze
57159,0,1355871600,94,57,24,2,177,A,Po%u0159ad%20sch%u016Fze
57160,0,1355871600,93,54,27,3,177,A,%20
57161,2,1355871600,101,78,3,1,183,A,Novela%20z.%20o%20p%u0159estupc%EDch
57162,4,1355871600,120,31,32,10,193,A,Novela%20z.%20-%20horn%ED%20z%E1kon
57163,7,1355871600,155,3,32,1,191,A,Vl.n.z.%20o%20St%E1tn%EDm%20pozemkov%E9m%20%FA%u0159adu
57164,7,1355871600,89,89,9,7,194,R,Vl.n.z.%20o%20St%E1tn%EDm%20pozemkov%E9m%20%FA%u0159adu
57165,7,1355871600,105,68,8,13,194,A,Vl.n.z.%20o%20St%E1tn%EDm%20pozemkov%E9m%20%FA%u0159adu
57166,8,1355871600,86,101,0,2,189,R,Novela%20z.%20o%20dani%20z%20p%u0159idan%E9%20hodnoty%20-%20EU
57167,8,1355871600,111,71,5,3,190,A,Novela%20z.%20o%20dani%20z%20p%u0159idan%E9%20hodnoty%20-%20EU
57168,157,1355871600,176,2,0,0,178,A,N%E1vrh%20na%20zm%u011Bny%20ve%20slo%u017Een%ED%20org%E1n%u016F%20Poslaneck%E9%20sn%u011Bmovny
57169,157,1355871600,174,1,1,3,179,A,N%E1vrh%20na%20zm%u011Bny%20ve%20slo%u017Een%ED%20org%E1n%u016F%20Poslaneck%E9%20sn%u011Bmovny
57170,156,1355871600,102,88,2,1,193,A,Vl.n.z.%20o%20zm%u011Bn%u011B%20da%u0148ov%FDch%2C%20pojistn%FDch%20a%20dal%u0161%EDch%20z%E1kon%u016F%20-%20EU
57171,103,1355871600,138,6,4,10,158,A,Vl.n.%20nov%E9ho%20z%E1kona%20o%20st%E1tn%EDm%20rozpo%u010Dtu%20%u010CR%20na%20rok%202013
57172,103,1355871600,164,9,12,3,188,A,Vl.n.%20nov%E9ho%20z%E1kona%20o%20st%E1tn%EDm%20rozpo%u010Dtu%20%u010CR%20na%20rok%202013
57173,103,1355871600,91,83,6,8,188,R,Vl.n.%20nov%E9ho%20z%E1kona%20o%20st%E1tn%EDm%20rozpo%u010Dtu%20%u010CR%20na%20rok%202013
57174,103,1355871600,87,97,3,1,188,R,Vl.n.%20nov%E9ho%20z%E1kona%20o%20st%E1tn%EDm%20rozpo%u010Dtu%20%u010CR%20na%20rok%202013
57175,103,1355871600,88,98,0,1,187,R,Vl.n.%20nov%E9ho%20z%E1kona%20o%20st%E1tn%EDm%20rozpo%u010Dtu%20%u010CR%20na%20rok%202013
57176,103,1355871600,82,98,1,7,188,R,Vl.n.%20nov%E9ho%20z%E1kona%20o%20st%E1tn%EDm%20rozpo%u010Dtu%20%u010CR%20na%20rok%202013
57177,103,1355871600,87,95,4,2,188,R,Vl.n.%20nov%E9ho%20z%E1kona%20o%20st%E1tn%EDm%20rozpo%u010Dtu%20%u010CR%20na%20rok%202013
57178,103,1355871600,87,99,1,1,188,R,Vl.n.%20nov%E9ho%20z%E1kona%20o%20st%E1tn%EDm%20rozpo%u010Dtu%20%u010CR%20na%20rok%202013
57179,103,1355871600,36,113,13,26,188,R,Vl.n.%20nov%E9ho%20z%E1kona%20o%20st%E1tn%EDm%20rozpo%u010Dtu%20%u010CR%20na%20rok%202013
57180,103,1355871600,118,30,21,18,187,A,Vl.n.%20nov%E9ho%20z%E1kona%20o%20st%E1tn%EDm%20rozpo%u010Dtu%20%u010CR%20na%20rok%202013
57181,103,1355871600,140,8,27,13,188,A,Vl.n.%20nov%E9ho%20z%E1kona%20o%20st%E1tn%EDm%20rozpo%u010Dtu%20%u010CR%20na%20rok%202013
57182,103,1355871600,81,102,2,3,188,R,Vl.n.%20nov%E9ho%20z%E1kona%20o%20st%E1tn%EDm%20rozpo%u010Dtu%20%u010CR%20na%20rok%202013
57183,103,1355871600,82,102,2,2,188,R,Vl.n.%20nov%E9ho%20z%E1kona%20o%20st%E1tn%EDm%20rozpo%u010Dtu%20%u010CR%20na%20rok%202013
57184,103,1355871600,84,98,3,3,188,R,Vl.n.%20nov%E9ho%20z%E1kona%20o%20st%E1tn%EDm%20rozpo%u010Dtu%20%u010CR%20na%20rok%202013
57185,103,1355871600,83,101,2,2,188,R,Vl.n.%20nov%E9ho%20z%E1kona%20o%20st%E1tn%EDm%20rozpo%u010Dtu%20%u010CR%20na%20rok%202013
57186,103,1355871600,85,99,3,1,188,R,Vl.n.%20nov%E9ho%20z%E1kona%20o%20st%E1tn%EDm%20rozpo%u010Dtu%20%u010CR%20na%20rok%202013
57187,103,1355871600,100,86,0,2,188,A,Vl.n.%20nov%E9ho%20z%E1kona%20o%20st%E1tn%EDm%20rozpo%u010Dtu%20%u010CR%20na%20rok%202013
57188,103,1355871600,80,97,2,7,186,R,Vl.n.%20nov%E9ho%20z%E1kona%20o%20st%E1tn%EDm%20rozpo%u010Dtu%20%u010CR%20na%20rok%202013
57189,104,1355871600,86,73,0,1,160,A,Nov%FD%20n%E1vrh%20st%u0159edn%u011Bdob%FDch%20v%FDdaj.r%E1mc%u016F%20na%20l%E9ta%202014%20a%202015
57190,105,1355871600,86,22,22,13,143,A,Rozpo%u010Det%20SFDI%20na%20rok%202013
57191,106,1355871600,109,20,9,13,151,A,N%E1vrh%20rozpo%u010Dtu%20St%E1tn%EDho%20fondu%20rozvoje%20bydlen%ED%20na%20rok%202013
57192,107,1355871600,134,5,11,2,152,A,N%E1vrh%20rozpo%u010Dtu%20SZIF%20na%20rok%202013
57193,166,1355871600,144,0,7,2,153,A,N%E1vrh%20na%20potvrzen%ED%20p%u0159edsed%u016F%20v%FDbor%u016F%20Poslaneck%E9%20sn%u011Bmovny
57194,166,1355871600,140,0,8,3,151,A,N%E1vrh%20na%20potvrzen%ED%20p%u0159edsed%u016F%20v%FDbor%u016F%20Poslaneck%E9%20sn%u011Bmovny
57195,166,1355871600,128,1,16,6,151,A,N%E1vrh%20na%20potvrzen%ED%20p%u0159edsed%u016F%20v%FDbor%u016F%20Poslaneck%E9%20sn%u011Bmovny
57196,0,1355871600,120,9,15,3,147,A,%20
57197,0,1358377200,116,0,29,0,145,A,%20
57198,1,1358377200,115,37,11,15,178,A,N%E1vrh%20na%20vysloven%ED%20ned%u016Fv%u011Bry%20vl%E1d%u011B%20%u010Cesk%E9%20republiky
57199,1,1358377200,92,97,0,0,189,R,N%E1vrh%20na%20vysloven%ED%20ned%u016Fv%u011Bry%20vl%E1d%u011B%20%u010Cesk%E9%20republiky
57200,1,1358377200,86,93,2,1,182,R,N%E1vrh%20na%20vysloven%ED%20ned%u016Fv%u011Bry%20vl%E1d%u011B%20%u010Cesk%E9%20republiky
57201,0,1360018800,135,0,30,0,165,A,%20
57202,0,1360018800,133,0,51,2,186,A,Po%u0159ad%20sch%u016Fze
57203,0,1360018800,101,10,51,24,186,A,Po%u0159ad%20sch%u016Fze
57204,0,1360018800,181,0,8,0,189,A,Po%u0159ad%20sch%u016Fze
57205,0,1360018800,91,72,16,11,190,R,Po%u0159ad%20sch%u016Fze
57206,0,1360018800,150,4,28,8,190,A,Po%u0159ad%20sch%u016Fze
57207,0,1360018800,2,0,127,0,129,R,Po%u0159ad%20sch%u016Fze
57208,0,1360018800,87,83,5,6,181,R,Po%u0159ad%20sch%u016Fze
57209,0,1360018800,84,86,11,3,184,R,Po%u0159ad%20sch%u016Fze
57210,0,1360018800,83,91,7,4,185,R,Po%u0159ad%20sch%u016Fze
57211,0,1360018800,87,89,7,2,185,R,Po%u0159ad%20sch%u016Fze
57212,0,1360018800,87,88,8,3,186,R,Po%u0159ad%20sch%u016Fze
57213,0,1360018800,61,89,31,5,186,R,Po%u0159ad%20sch%u016Fze
57214,0,1360018800,64,92,26,6,188,R,Po%u0159ad%20sch%u016Fze
57215,0,1360018800,85,96,6,1,188,R,Po%u0159ad%20sch%u016Fze
57216,0,1360018800,183,2,3,0,188,A,Po%u0159ad%20sch%u016Fze
57217,0,1360018800,85,86,12,5,188,R,Po%u0159ad%20sch%u016Fze
57218,0,1360018800,88,85,8,7,188,R,Po%u0159ad%20sch%u016Fze
57219,0,1360018800,88,89,7,4,188,R,Po%u0159ad%20sch%u016Fze
57220,0,1360018800,88,96,3,1,188,R,Po%u0159ad%20sch%u016Fze
57221,0,1360018800,88,91,7,2,188,R,Po%u0159ad%20sch%u016Fze
57222,0,1360018800,87,75,15,11,188,R,Po%u0159ad%20sch%u016Fze
57223,0,1360018800,89,78,15,6,188,R,Po%u0159ad%20sch%u016Fze
57224,0,1360018800,178,2,8,0,188,A,Po%u0159ad%20sch%u016Fze
57225,0,1360018800,98,72,15,3,188,A,Po%u0159ad%20sch%u016Fze
57226,0,1360018800,97,60,23,8,188,A,Po%u0159ad%20sch%u016Fze
57227,0,1360018800,109,35,31,14,189,A,Po%u0159ad%20sch%u016Fze
57228,0,1360018800,108,30,31,20,189,A,Po%u0159ad%20sch%u016Fze
57229,0,1360018800,179,3,5,2,189,A,Po%u0159ad%20sch%u016Fze
57230,0,1360018800,92,85,6,6,189,R,Po%u0159ad%20sch%u016Fze
57231,0,1360018800,177,0,10,2,189,A,Po%u0159ad%20sch%u016Fze
57232,0,1360018800,97,31,31,30,189,A,Po%u0159ad%20sch%u016Fze
57233,18,1360018800,83,67,1,11,162,A,Novela%20z.%20o%20jednac%EDm%20%u0159%E1du%20Poslaneck%E9%20sn%u011Bmovny
57234,31,1360018800,130,0,33,1,164,A,Novela%20z.%20o%20ochran%u011B%20ve%u0159ejn%E9ho%20zdrav%ED%20-%20EU
57235,31,1360018800,113,17,35,2,167,A,Novela%20z.%20o%20ochran%u011B%20ve%u0159ejn%E9ho%20zdrav%ED%20-%20EU
57236,20,1360018800,121,6,7,2,136,A,N.z.%20o%20%u010Cesk%E9m%20n%E1rodn%EDm%20povst%E1n%ED
57237,27,1360105200,78,104,1,0,183,R,Vl.n.%FAstav.z.%20o%20rozpo%u010Dtov%E9%20odpov%u011Bdnosti%20-%20EU
57238,27,1360105200,78,105,0,0,183,R,Vl.n.%FAstav.z.%20o%20rozpo%u010Dtov%E9%20odpov%u011Bdnosti%20-%20EU
57239,27,1360105200,178,1,4,0,183,A,Vl.n.%FAstav.z.%20o%20rozpo%u010Dtov%E9%20odpov%u011Bdnosti%20-%20EU
57240,25,1360105200,127,0,51,0,178,A,Vl.n.z.%20o%20mezin%E1rodn%ED%20spolupr%E1ci%20p%u0159i%20spr%E1v%u011B%20dan%ED%20-%20EU
57241,25,1360105200,132,0,47,0,179,A,Vl.n.z.%20o%20mezin%E1rodn%ED%20spolupr%E1ci%20p%u0159i%20spr%E1v%u011B%20dan%ED%20-%20EU
57242,25,1360105200,95,25,50,9,179,A,Vl.n.z.%20o%20mezin%E1rodn%ED%20spolupr%E1ci%20p%u0159i%20spr%E1v%u011B%20dan%ED%20-%20EU
57243,25,1360105200,144,2,33,0,179,A,Vl.n.z.%20o%20mezin%E1rodn%ED%20spolupr%E1ci%20p%u0159i%20spr%E1v%u011B%20dan%ED%20-%20EU
57244,25,1360105200,83,31,21,16,151,A,Vl.n.z.%20o%20mezin%E1rodn%ED%20spolupr%E1ci%20p%u0159i%20spr%E1v%u011B%20dan%ED%20-%20EU
57245,23,1360105200,80,84,2,0,166,R,Novela%20z.%20o%20stavebn%EDm%20spo%u0159en%ED%20-%20EU
57246,23,1360105200,154,4,9,2,169,A,Novela%20z.%20o%20stavebn%EDm%20spo%u0159en%ED%20-%20EU
57247,23,1360105200,82,85,2,0,169,R,Novela%20z.%20o%20stavebn%EDm%20spo%u0159en%ED%20-%20EU
57248,23,1360105200,165,3,1,0,169,A,Novela%20z.%20o%20stavebn%EDm%20spo%u0159en%ED%20-%20EU
57249,23,1360105200,103,38,17,11,169,A,Novela%20z.%20o%20stavebn%EDm%20spo%u0159en%ED%20-%20EU
57250,23,1360105200,166,1,2,0,169,A,Novela%20z.%20o%20stavebn%EDm%20spo%u0159en%ED%20-%20EU
57251,117,1360105200,120,0,44,0,164,A,%DAmluva%20o%20po%u010D%EDta%u010Dov%E9%20kriminalit%u011B
57252,105,1360105200,119,1,40,3,163,A,%DAml.%20o%20boji%20proti%20korupci%20%FA%u0159edn%EDk%u016F%20Evropsk%FDch%20spole%u010Denstv%ED
57253,106,1360105200,121,0,46,1,168,A,%DAml.%20o%20ochran%u011B%20finan%u010Dn%EDch%20z%E1jm%u016F%20Evropsk%FDch%20spole%u010Denstv%ED
57254,22,1360105200,103,1,60,1,165,A,Novela%20z.%20o%20silni%u010Dn%EDm%20provozu
57255,24,1360105200,107,0,57,0,164,A,Novela%20z.%20o%20obchodu%20s%20reproduk%u010Dn%EDm%20materi%E1lem%20lesn%EDch%20d%u0159evin%20-%20EU
57256,26,1360105200,109,1,54,0,164,A,Vl.n.z.%20o%20uv%E1d%u011Bn%ED%20d%u0159eva%20a%20d%u0159eva%u0159sk%FDch%20v%FDrobk%u016F%20na%20trh%20-%20EU
57257,28,1360105200,109,0,56,0,165,A,Vl%E1dn%ED%20n%E1vrh%20z%E1kona%20o%20sm%u011Bn%E1rensk%E9%20%u010Dinnosti%20-%20EU
57258,29,1360105200,105,0,56,0,161,A,Novela%20z.%20o%20sm%u011Bn%E1rensk%E9%20%u010Dinnosti%20-%20souvisej%EDc%ED
57259,30,1360105200,39,54,19,2,114,R,Novela%20z.%20o%20poji%u0161%u0165ovac%EDch%20zprost%u0159edkovatel%EDch%20-%20EU
57260,30,1360105200,113,0,2,1,116,A,Novela%20z.%20o%20poji%u0161%u0165ovac%EDch%20zprost%u0159edkovatel%EDch%20-%20EU
57261,30,1360105200,81,33,1,1,116,A,Novela%20z.%20o%20poji%u0161%u0165ovac%EDch%20zprost%u0159edkovatel%EDch%20-%20EU
57262,32,1360105200,94,1,23,0,118,A,Novela%20z.%20o%20%u010Cesk%E9%20n%E1rodn%ED%20bance%20-%20EU
57263,33,1360105200,111,0,14,0,125,A,Vl.n.z.%20o%20investi%u010Dn%EDch%20spole%u010Dnostech%20a%20investi%u010Dn%EDch%20fondech%20-%20EU
57264,33,1360105200,57,28,35,5,125,R,Vl.n.z.%20o%20investi%u010Dn%EDch%20spole%u010Dnostech%20a%20investi%u010Dn%EDch%20fondech%20-%20EU
57265,34,1360105200,101,0,24,0,125,A,Vl.n.z.%20o%20investi%u010Dn%EDch%20spol.%20a%20inv.%20fondech%20-%20souvisej%EDc%ED%20-%20EU
57266,35,1360105200,95,0,29,0,124,A,Novela%20z.%20o%20finan%u010Dn%EDch%20konglomer%E1tech%20-%20EU
57267,35,1360105200,94,0,28,0,122,A,Novela%20z.%20o%20finan%u010Dn%EDch%20konglomer%E1tech%20-%20EU
57268,37,1360105200,98,5,19,2,124,A,Novela%20z.%20o%20v%E1le%u010Dn%FDch%20veter%E1nech
57269,38,1360105200,101,0,22,1,124,A,Novela%20z.%20o%20zm%EDrn%u011Bn%ED%20n%E1sledk%u016F%20n%u011Bkter%FDch%20majetkov%FDch%20k%u0159ivd
57270,0,1360191600,58,2,18,3,81,A,Po%u0159ad%20sch%u016Fze
57271,0,1360191600,61,4,13,3,81,A,Po%u0159ad%20sch%u016Fze
57272,173,1360191600,38,35,21,0,94,R,P%EDsemn%E1%20interpelace%20M.%20V%E1ni%20na%20P.%20Ne%u010Dase%20ve%20v%u011Bci%20z%E1kona%20o%20majetkov%E9m%20v
57273,118,1360191600,99,0,20,0,119,A,%DAml.%20proti%20nadn%E1rodn%EDmu%20organizovan%E9mu%20zlo%u010Dinu
57274,104,1360191600,109,0,16,0,125,A,N%E1vrh%20na%u0159%EDzen%ED%20Rady%20o%20otev%u0159en%ED%20historick%FDch%20archiv%u016F
57275,148,1360191600,112,1,15,3,131,A,Zpr%E1va%20o%20extremismu%20na%20%FAzem%ED%20%u010CR%20v%20roce%202011
57276,109,1360191600,117,0,15,1,133,A,Sml.mezi%20%u010CR%20a%20Polskou%20rep.%20o%20spole%u010Dn%FDch%20st%E1tn%EDch%20hranic%EDch
57277,39,1360191600,38,82,1,3,124,R,Novela%20z.%20o%20po%u0161tovn%EDch%20slu%u017Eb%E1ch
57278,39,1360191600,118,0,6,0,124,A,Novela%20z.%20o%20po%u0161tovn%EDch%20slu%u017Eb%E1ch
57279,107,1360191600,112,0,15,0,127,A,Prot.mezi%20%u010CR%20a%20%u0160v%FDcarskou%20spol.radou%20o%20zamezen%ED%20dvoj.zdan%u011Bn%ED
57280,108,1360191600,112,0,17,0,129,A,Doh.%20o%20partnerstv%ED%20a%20spolupr%E1ci%20mezi%20st%E1ty%20EU%20a%20Ir%E1ckou%20rep.
57281,110,1360191600,113,0,16,0,129,A,Dohoda%20o%20spol.%20leteck%E9m%20prostoru%20mezi%20EU%20a%20Moldavskou%20rep.
57282,111,1360191600,113,0,19,0,132,A,Prot.%20mezi%20%u010CR%20a%20Nizozemsk%FDm%20kr%E1l.%20o%20zamezen%ED%20dvoj%EDho%20zdan%u011Bn%ED
57283,112,1360191600,115,1,17,0,133,A,Sml.mezi%20%u010CR%20a%20Brazil.fed.rep.o%20pomoci%20v%20celn%EDch%20ot%E1zk%E1ch
57284,113,1360191600,101,0,33,0,134,A,Obchodn%ED%20doh.mezi%20st%E1ty%20EU%20a%20Kolumbi%ED%20a%20Peru
57285,113,1360191600,113,0,20,0,133,A,Obchodn%ED%20doh.mezi%20st%E1ty%20EU%20a%20Kolumbi%ED%20a%20Peru
57286,114,1360191600,100,2,31,0,133,A,Doh.zakl%E1daj%EDc%ED%20p%u0159idru%u017Een%ED%20mezi%20st%E1ty%20EU%20a%20St%u0159edn%ED%20Amerikou
57287,114,1360191600,24,0,109,0,133,R,Doh.zakl%E1daj%EDc%ED%20p%u0159idru%u017Een%ED%20mezi%20st%E1ty%20EU%20a%20St%u0159edn%ED%20Amerikou
57288,114,1360191600,102,0,6,0,108,A,Doh.zakl%E1daj%EDc%ED%20p%u0159idru%u017Een%ED%20mezi%20st%E1ty%20EU%20a%20St%u0159edn%ED%20Amerikou
57289,115,1360191600,105,0,6,0,111,A,Doh.mezi%20%u010CR%20a%20vl.Kajmansk%FDch%20os.%20o%20v%FDm%u011Bn%u011B%20inf.v%20da%u0148.z%E1le%u017E.
57290,116,1360191600,96,0,17,2,115,A,%DAml.o%20vz%E1jemn%E9%20spr%E1vn%ED%20pomoci%20v%20da%u0148.z%E1le%u017Eitostech
57291,116,1360191600,104,0,11,0,115,A,%DAml.o%20vz%E1jemn%E9%20spr%E1vn%ED%20pomoci%20v%20da%u0148.z%E1le%u017Eitostech
57292,40,1360191600,87,0,35,2,124,A,Novela%20z.%20o%20obc%EDch
57293,40,1360191600,22,58,38,12,130,R,Novela%20z.%20o%20obc%EDch
57294,40,1360191600,111,0,19,0,130,A,Novela%20z.%20o%20obc%EDch
57295,40,1360191600,106,3,21,0,130,A,Novela%20z.%20o%20obc%EDch
57296,40,1360191600,106,5,19,1,131,A,Novela%20z.%20o%20obc%EDch
57297,0,1360278000,101,38,13,4,156,A,Po%u0159ad%20sch%u016Fze
57298,0,1360278000,156,0,5,0,161,A,Po%u0159ad%20sch%u016Fze
57299,92,1360278000,147,1,15,1,164,A,Novela%20z.%20o%20pohonn%FDch%20hmot%E1ch
57300,89,1360278000,159,1,12,0,172,A,Novela%20z.%20o%20st%E1tn%EDch%20sv%E1tc%EDch
57301,89,1360278000,153,4,14,1,172,A,Novela%20z.%20o%20st%E1tn%EDch%20sv%E1tc%EDch
57302,129,1360278000,85,77,6,3,171,R,Novela%20z.%20o%20jednac%EDm%20%u0159%E1du%20Poslaneck%E9%20sn%u011Bmovny
57303,129,1360278000,167,2,1,0,170,A,Novela%20z.%20o%20jednac%EDm%20%u0159%E1du%20Poslaneck%E9%20sn%u011Bmovny
57304,129,1360278000,84,82,0,3,169,R,Novela%20z.%20o%20jednac%EDm%20%u0159%E1du%20Poslaneck%E9%20sn%u011Bmovny
57305,129,1360278000,150,15,5,0,170,A,Novela%20z.%20o%20jednac%EDm%20%u0159%E1du%20Poslaneck%E9%20sn%u011Bmovny
57306,129,1360278000,86,83,0,2,171,A,Novela%20z.%20o%20jednac%EDm%20%u0159%E1du%20Poslaneck%E9%20sn%u011Bmovny
57307,129,1360278000,123,1,45,2,171,A,Novela%20z.%20o%20jednac%EDm%20%u0159%E1du%20Poslaneck%E9%20sn%u011Bmovny
57308,129,1360278000,165,4,3,0,172,A,Novela%20z.%20o%20jednac%EDm%20%u0159%E1du%20Poslaneck%E9%20sn%u011Bmovny
57309,129,1360278000,87,84,0,1,172,A,Novela%20z.%20o%20jednac%EDm%20%u0159%E1du%20Poslaneck%E9%20sn%u011Bmovny
57310,129,1360278000,161,0,7,4,172,A,Novela%20z.%20o%20jednac%EDm%20%u0159%E1du%20Poslaneck%E9%20sn%u011Bmovny
57311,129,1360278000,91,60,18,2,171,A,Novela%20z.%20o%20jednac%EDm%20%u0159%E1du%20Poslaneck%E9%20sn%u011Bmovny
57312,129,1360278000,162,4,5,1,172,A,Novela%20z.%20o%20jednac%EDm%20%u0159%E1du%20Poslaneck%E9%20sn%u011Bmovny
57313,129,1360278000,90,66,15,1,172,A,Novela%20z.%20o%20jednac%EDm%20%u0159%E1du%20Poslaneck%E9%20sn%u011Bmovny
57314,129,1360278000,88,83,1,0,172,A,Novela%20z.%20o%20jednac%EDm%20%u0159%E1du%20Poslaneck%E9%20sn%u011Bmovny
57315,129,1360278000,35,100,11,27,173,R,Novela%20z.%20o%20jednac%EDm%20%u0159%E1du%20Poslaneck%E9%20sn%u011Bmovny
57316,129,1360278000,89,81,1,2,173,A,Novela%20z.%20o%20jednac%EDm%20%u0159%E1du%20Poslaneck%E9%20sn%u011Bmovny
57317,129,1360278000,161,2,10,0,173,A,Novela%20z.%20o%20jednac%EDm%20%u0159%E1du%20Poslaneck%E9%20sn%u011Bmovny
57318,129,1360278000,88,82,1,2,173,A,Novela%20z.%20o%20jednac%EDm%20%u0159%E1du%20Poslaneck%E9%20sn%u011Bmovny
57319,129,1360278000,158,9,3,3,173,A,Novela%20z.%20o%20jednac%EDm%20%u0159%E1du%20Poslaneck%E9%20sn%u011Bmovny
57320,129,1360278000,148,4,11,10,173,A,Novela%20z.%20o%20jednac%EDm%20%u0159%E1du%20Poslaneck%E9%20sn%u011Bmovny
57321,129,1360278000,136,16,10,10,172,A,Novela%20z.%20o%20jednac%EDm%20%u0159%E1du%20Poslaneck%E9%20sn%u011Bmovny
57322,129,1360278000,88,83,0,2,173,A,Novela%20z.%20o%20jednac%EDm%20%u0159%E1du%20Poslaneck%E9%20sn%u011Bmovny
57323,130,1360278000,123,0,5,4,132,A,Novela%20z.%20o%20jednac%EDm%20%u0159%E1du%20Sen%E1tu
57324,36,1360278000,98,27,18,3,146,A,Vl.n.z.%20o%20ozna%u010D.%20a%20sledovatel.%20v%FDbu%u0161nin%20pro%20civiln%ED%20pou%u017Eit%ED%20-%20EU
57325,36,1360278000,95,28,20,5,148,A,Vl.n.z.%20o%20ozna%u010D.%20a%20sledovatel.%20v%FDbu%u0161nin%20pro%20civiln%ED%20pou%u017Eit%ED%20-%20EU
57326,41,1360278000,122,0,26,0,148,A,Novela%20z.%20o%20st%E1tn%EDm%20podniku
57327,41,1360278000,109,3,35,1,148,A,Novela%20z.%20o%20st%E1tn%EDm%20podniku
57328,42,1360278000,77,65,1,2,145,A,Novela%20z.%20o%20dani%20z%20p%u0159idan%E9%20hodnoty
57329,44,1360278000,69,63,1,2,135,A,Novela%20z.%20-%20ob%u010Dansk%FD%20z%E1kon%EDk
57330,0,1360623600,73,77,5,3,158,R,Po%u0159ad%20sch%u016Fze
57331,0,1360623600,72,78,6,5,161,R,Po%u0159ad%20sch%u016Fze
57332,0,1360623600,79,73,5,4,161,R,Po%u0159ad%20sch%u016Fze
57333,0,1360623600,75,76,6,5,162,R,Po%u0159ad%20sch%u016Fze
57334,0,1360623600,70,78,10,4,162,R,Po%u0159ad%20sch%u016Fze
57335,0,1360623600,78,76,6,3,163,R,Po%u0159ad%20sch%u016Fze
57336,0,1360623600,77,79,5,1,162,R,Po%u0159ad%20sch%u016Fze
57337,0,1360623600,96,30,21,15,162,A,Po%u0159ad%20sch%u016Fze
57338,0,1360623600,86,62,8,6,162,A,Po%u0159ad%20sch%u016Fze
57339,0,1360623600,84,64,14,3,165,A,Po%u0159ad%20sch%u016Fze
57340,0,1360623600,77,49,13,25,164,R,Po%u0159ad%20sch%u016Fze
57341,0,1360623600,96,63,1,5,165,A,Po%u0159ad%20sch%u016Fze
57342,0,1360623600,116,21,7,21,165,A,Po%u0159ad%20sch%u016Fze
57343,0,1360623600,97,40,15,13,165,A,Po%u0159ad%20sch%u016Fze
57344,0,1360623600,83,51,24,7,165,A,Po%u0159ad%20sch%u016Fze
57345,0,1360623600,77,49,16,23,165,R,Po%u0159ad%20sch%u016Fze
57346,0,1360623600,58,82,20,5,165,R,Po%u0159ad%20sch%u016Fze
57347,0,1360623600,78,74,6,7,165,R,Po%u0159ad%20sch%u016Fze
57348,0,1360623600,141,8,13,3,165,A,Po%u0159ad%20sch%u016Fze
57349,0,1360623600,80,76,1,5,162,R,Po%u0159ad%20sch%u016Fze
57350,98,1360623600,74,75,5,0,154,R,Novela%20z.%20o%20dani%20z%20p%u0159idan%E9%20hodnoty
57351,98,1360623600,139,6,10,2,157,A,Novela%20z.%20o%20dani%20z%20p%u0159idan%E9%20hodnoty
57352,98,1360623600,81,75,1,0,157,A,Novela%20z.%20o%20dani%20z%20p%u0159idan%E9%20hodnoty
57353,103,1360623600,78,71,10,3,162,R,Novela%20z.%20o%20pozemn%EDch%20komunikac%EDch
57354,103,1360623600,138,7,18,1,164,A,Novela%20z.%20o%20pozemn%EDch%20komunikac%EDch
57355,103,1360623600,81,69,2,2,154,A,Novela%20z.%20o%20pozemn%EDch%20komunikac%EDch
57356,99,1360623600,134,0,21,0,155,A,Novela%20z.%20o%20poji%u0161%u0165ovnictv%ED
57357,99,1360623600,137,13,10,1,161,A,Novela%20z.%20o%20poji%u0161%u0165ovnictv%ED
57358,100,1360623600,85,81,0,0,166,A,N.z.o%20zm%u011Bn%u011B%20z%E1k.%20souvisej%EDc%ED%20se%20zaveden%EDm%20karty%20soc.%20syst%E9m%u016F
57359,101,1360623600,141,1,19,0,161,A,Novela%20z.%20-%20z%E1kon%EDk%20pr%E1ce
57360,101,1360623600,81,55,21,4,161,A,Novela%20z.%20-%20z%E1kon%EDk%20pr%E1ce
57361,102,1360623600,70,62,7,6,145,R,N.z.%20o%20N%E1rodn%EDm%20parku%20%u0160umava
57362,102,1360623600,142,1,5,0,148,A,N.z.%20o%20N%E1rodn%EDm%20parku%20%u0160umava
57363,102,1360623600,134,6,8,0,148,A,N.z.%20o%20N%E1rodn%EDm%20parku%20%u0160umava
57364,0,1360623600,98,26,10,2,136,A,%20
57365,84,1360623600,49,43,30,16,138,R,Novela%20z.%20o%20elektronick%FDch%20komunikac%EDch
57366,84,1360623600,134,1,1,3,139,A,Novela%20z.%20o%20elektronick%FDch%20komunikac%EDch
57367,48,1360623600,131,0,10,0,141,A,Novela%20z.%20o%20dan%EDch%20z%20p%u0159%EDjm%u016F
57368,48,1360623600,136,0,7,0,143,A,Novela%20z.%20o%20dan%EDch%20z%20p%u0159%EDjm%u016F
57369,0,1360710000,69,24,26,9,128,A,Po%u0159ad%20sch%u016Fze
57370,119,1360710000,140,0,8,2,150,A,Vl.n.z.o%20mezin%E1rodn%ED%20justi%u010Dn%ED%20spolupr%E1ci%20ve%20v%u011Bcech%20trestn%EDch%20-%20EU
57371,119,1360710000,144,0,7,2,153,A,Vl.n.z.o%20mezin%E1rodn%ED%20justi%u010Dn%ED%20spolupr%E1ci%20ve%20v%u011Bcech%20trestn%EDch%20-%20EU
57372,120,1360710000,146,0,5,4,155,A,Vl.n.z.o%20zm%u011Bn%u011B%20z%E1k.v%20souv.s%20p%u0159ijet%EDm%20z.o%20mezin.just.spolupr.%20-%20EU
57373,120,1360710000,152,0,1,3,156,A,Vl.n.z.o%20zm%u011Bn%u011B%20z%E1k.v%20souv.s%20p%u0159ijet%EDm%20z.o%20mezin.just.spolupr.%20-%20EU
57374,121,1360710000,162,2,2,1,167,A,Novela%20z.%20o%20odpadech%20-%20EU
57375,121,1360710000,79,82,4,2,167,R,Novela%20z.%20o%20odpadech%20-%20EU
57376,121,1360710000,163,0,4,1,168,A,Novela%20z.%20o%20odpadech%20-%20EU
57377,121,1360710000,164,0,2,2,168,A,Novela%20z.%20o%20odpadech%20-%20EU
57378,121,1360710000,163,0,3,2,168,A,Novela%20z.%20o%20odpadech%20-%20EU
57379,121,1360710000,4,155,4,4,167,R,Novela%20z.%20o%20odpadech%20-%20EU
57380,121,1360710000,3,159,3,3,168,R,Novela%20z.%20o%20odpadech%20-%20EU
57381,121,1360710000,2,162,4,0,168,R,Novela%20z.%20o%20odpadech%20-%20EU
57382,121,1360710000,71,76,10,10,167,R,Novela%20z.%20o%20odpadech%20-%20EU
57383,121,1360710000,113,26,11,17,167,A,Novela%20z.%20o%20odpadech%20-%20EU
57384,121,1360710000,140,6,5,16,167,A,Novela%20z.%20o%20odpadech%20-%20EU
57385,122,1360710000,92,9,28,34,163,A,Vl.n.z.%20o%20zm%u011Bn%u011B%20z%E1k.%20v%20oblasti%20poji%u0161%u0165ov.%20a%20penzij.%20p%u0159ipoji%u0161.%20-%20EU
57386,122,1360710000,84,27,22,33,166,A,Vl.n.z.%20o%20zm%u011Bn%u011B%20z%E1k.%20v%20oblasti%20poji%u0161%u0165ov.%20a%20penzij.%20p%u0159ipoji%u0161.%20-%20EU
57387,123,1360710000,151,1,14,1,167,A,Novela%20z.%20o%20silni%u010Dn%ED%20doprav%u011B%20-%20EU
57388,123,1360710000,153,0,13,2,168,A,Novela%20z.%20o%20silni%u010Dn%ED%20doprav%u011B%20-%20EU
57389,123,1360710000,144,6,14,3,167,A,Novela%20z.%20o%20silni%u010Dn%ED%20doprav%u011B%20-%20EU
57390,123,1360710000,147,8,11,2,168,A,Novela%20z.%20o%20silni%u010Dn%ED%20doprav%u011B%20-%20EU
57391,124,1360710000,147,0,20,1,168,A,Novela%20z.%20o%20technick%FDch%20po%u017Eadavc%EDch%20na%20v%FDrobky%20-%20EU
57392,124,1360710000,153,0,14,1,168,A,Novela%20z.%20o%20technick%FDch%20po%u017Eadavc%EDch%20na%20v%FDrobky%20-%20EU
57393,126,1360710000,50,67,21,29,167,R,Novela%20%FAstav.%20z.%20-%20%DAstava%20%u010Cesk%E9%20republiky
57394,126,1360710000,156,4,5,4,169,A,Novela%20%FAstav.%20z.%20-%20%DAstava%20%u010Cesk%E9%20republiky
57395,126,1360710000,50,72,14,32,168,R,Novela%20%FAstav.%20z.%20-%20%DAstava%20%u010Cesk%E9%20republiky
57396,126,1360710000,151,4,6,6,167,A,Novela%20%FAstav.%20z.%20-%20%DAstava%20%u010Cesk%E9%20republiky
57397,126,1360710000,148,5,2,7,162,A,Novela%20%FAstav.%20z.%20-%20%DAstava%20%u010Cesk%E9%20republiky
57398,128,1360710000,142,1,24,2,169,A,Novela%20z.%20-%20autorsk%FD%20z%E1kon
57399,128,1360710000,119,3,38,9,169,A,Novela%20z.%20-%20autorsk%FD%20z%E1kon
57400,128,1360710000,91,7,50,21,169,A,Novela%20z.%20-%20autorsk%FD%20z%E1kon
57401,128,1360710000,61,59,24,24,168,R,Novela%20z.%20-%20autorsk%FD%20z%E1kon
57402,128,1360710000,24,89,31,24,168,R,Novela%20z.%20-%20autorsk%FD%20z%E1kon
57403,128,1360710000,20,70,57,21,168,R,Novela%20z.%20-%20autorsk%FD%20z%E1kon
57404,128,1360710000,12,72,60,24,168,R,Novela%20z.%20-%20autorsk%FD%20z%E1kon
57405,128,1360710000,85,11,48,25,169,A,Novela%20z.%20-%20autorsk%FD%20z%E1kon
57406,128,1360710000,73,9,50,36,168,R,Novela%20z.%20-%20autorsk%FD%20z%E1kon
57407,128,1360710000,147,2,6,1,156,A,Novela%20z.%20-%20autorsk%FD%20z%E1kon
57408,128,1360710000,74,18,33,34,159,R,Novela%20z.%20-%20autorsk%FD%20z%E1kon
57409,128,1360710000,146,4,8,1,159,A,Novela%20z.%20-%20autorsk%FD%20z%E1kon
57410,128,1360710000,74,25,29,31,159,R,Novela%20z.%20-%20autorsk%FD%20z%E1kon
57411,128,1360710000,125,5,27,3,160,A,Novela%20z.%20-%20autorsk%FD%20z%E1kon
57412,128,1360710000,78,25,37,22,162,R,Novela%20z.%20-%20autorsk%FD%20z%E1kon
57413,128,1360710000,103,11,18,29,161,A,Novela%20z.%20-%20autorsk%FD%20z%E1kon
57414,90,1360710000,117,0,35,0,152,A,Vl.%20n.%20z.%20o%20nakl%E1d%E1n%ED%20s%20bezpe%u010Dnostn%EDm%20materi%E1lem
57415,94,1360710000,126,0,29,0,155,A,Novela%20z.%20o%20ov%u011B%u0159ov%E1n%ED%20st%u0159eln%FDch%20zbran%ED
57416,75,1360710000,109,0,2,1,112,A,Novela%20z.%20o%20poji%u0161%u0165ov%E1n%ED%20a%20fin.%20v%FDvozu%20se%20st%E1tn%ED%20podporou
57417,91,1360710000,117,6,15,8,146,A,Novela%20z.%20o%20st%E1tn%ED%20soci%E1ln%ED%20podpo%u0159e
57418,91,1360710000,107,18,16,8,149,A,Novela%20z.%20o%20st%E1tn%ED%20soci%E1ln%ED%20podpo%u0159e
57419,71,1360710000,138,0,15,0,153,A,Novela%20z.%20o%20m%EDstn%EDch%20poplatc%EDch
57420,71,1360710000,101,29,19,4,153,A,Novela%20z.%20o%20m%EDstn%EDch%20poplatc%EDch
57421,71,1360710000,69,47,32,5,153,R,Novela%20z.%20o%20m%EDstn%EDch%20poplatc%EDch
57422,82,1360710000,133,1,16,0,150,A,Vl.n.z.o%20poskyt.st.z%E1ruky%20%u010CR%20na%20zaji%u0161t%u011Bn%ED%20p%u016Fj%u010Dky%20%u010CNB%20pro%20MMF
57423,149,1360796400,101,0,6,3,110,A,1.%20dopln%u011Bk%20pl%E1nu%20voj.%20cvi%u010Den%ED%20A%u010CR%20v%20roce%202012
57424,0,1360796400,100,5,8,1,114,A,%20
57425,150,1360796400,85,14,13,2,114,A,Rozh.vl.%20o%20p%u0159eletech%20a%20pr%u016Fj.ozbroj.sil%20p%u0159es%20%FAzem%ED%20%u010CR%20-%202013
57426,151,1360796400,91,14,12,1,118,A,Inf.%20o%20nasazen%ED%20sil%20MO%20v%20zahrani%u010Dn%EDch%20operac%EDch%20v%20roce%202011
57427,152,1360796400,93,0,23,2,118,A,Inf.o%20vojensk%FDch%20cvi%u010Den%EDch%20A%u010CR%20za%20obdob%ED%20leden%20-%20%u010Derven%202012
57428,153,1360796400,81,16,19,3,119,A,Inf.%20o%20p%u0159eletech%20a%20pr%u016Fjezdech%20ozbroj.%20sil%20v%201.%20pol.%202012
57429,154,1360796400,96,5,14,3,118,A,2.dopln%u011Bk%20pl%E1nu%20voj.cvi%u010Den%ED%20A%u010CR%20se%20zahr.partnery%20v%20roce%202012
57430,155,1360796400,99,1,18,2,120,A,Inf.o%20voj.cv.%20A%u010CR%20se%20zahr.partnery%20v%20roce%202013
57431,143,1360796400,100,0,22,0,122,A,V%FDro%u010Dn%ED%20zpr%E1va%20%u010Cesk%E9ho%20telekomunika%u010Dn%EDho%20%FA%u0159adu%20za%20rok%202011
57432,144,1360796400,99,1,25,0,125,A,Informace%20o%20podpo%u0159en%E9m%20financov%E1n%ED%20za%20rok%202011
57433,145,1360796400,88,1,34,1,124,A,Inf.%20o%20poji%u0161%u0165ov%E1n%ED%20v%FDvozu%20se%20st%E1tn%ED%20podporou%20v%20roce%202011
57434,146,1360796400,105,0,19,0,124,A,Zpr%E1va%20o%20%u010Dinnosti%20a%20hospoda%u0159en%ED%20ER%DA%20za%20rok%202011
57435,147,1360796400,96,0,27,2,125,A,%DAmluva%20MOP%20%u010D.%20189%20o%20pracovn%EDc%EDch%20v%20ciz%ED%20dom%E1cnosti
57436,156,1360796400,91,0,34,1,126,A,Inf.vl%E1dy%20%u010CR%20o%20stavu%20realiz.Plav.stup%u0148%u016F%20na%20labsk%E9%20vod.cest%u011B
57437,157,1360796400,93,1,30,1,125,A,V%FDro%u010Dn%ED%20zpr%E1va%20o%20%u010Dinnosti%20a%20hospoda%u0159en%ED%20%u010CTK%20v%20roce%202011
57438,158,1360796400,78,8,37,3,126,A,V%FDro%u010Dn%ED%20zpr%E1va%20o%20hospoda%u0159en%ED%20%u010Cesk%E9ho%20rozhlasu%20za%20rok%202011
57439,159,1360796400,77,26,20,3,126,A,V%FDro%u010Dn%ED%20zpr%E1va%20o%20hospoda%u0159en%ED%20%u010Cesk%E9%20televize%20v%20roce%202011
57440,160,1360796400,101,0,25,1,127,A,Inf.o%20p%u0159%EDprav%u011B%20III.etapy%20realizace%20protipovod%u0148ov%FDch%20opat%u0159en%ED
57441,161,1360796400,90,3,29,4,126,A,Zpr%E1va%20o%20stavu%20zem%u011Bd%u011Blstv%ED%20%u010CR%20za%20rok%202011
57442,162,1360796400,40,62,21,3,126,R,V%FDro%u010Dn%ED%20zpr%E1va%20o%20%u010Dinnosti%20Pozemkov%E9ho%20fondu%20%u010CR%20za%20rok%202011
57443,162,1360796400,65,25,30,7,127,A,V%FDro%u010Dn%ED%20zpr%E1va%20o%20%u010Dinnosti%20Pozemkov%E9ho%20fondu%20%u010CR%20za%20rok%202011
57444,163,1360796400,91,1,29,4,125,A,Dota%u010Dn%ED%20programy%20zem%u011Bd%u011Blstv%ED%20pro%20rok%202013
57445,0,1360882800,74,14,27,13,128,A,Po%u0159ad%20sch%u016Fze
57446,0,1360882800,88,10,24,7,129,A,Po%u0159ad%20sch%u016Fze
57447,132,1360882800,123,2,4,1,130,A,Novela%20z.%20o%20silni%u010Dn%EDm%20provozu
57448,132,1360882800,129,0,5,0,134,A,Novela%20z.%20o%20silni%u010Dn%EDm%20provozu
57449,49,1360882800,122,1,15,2,140,A,Novela%20z.%20o%20platu%20p%u0159edstavitel%u016F%20st%E1tn%ED%20moci
57450,57,1360882800,123,0,19,0,142,A,Novela%20%FAstav.%20z.%20-%20%DAstava%20%u010Cesk%E9%20republiky
57451,172,1360882800,115,1,26,0,142,A,N%E1vrh%20Pravidel%20hospoda%u0159en%ED%20poslaneck%FDch%20klub%u016F%20pro%20rok%202013
57452,78,1360882800,114,1,28,0,143,A,Vl.n.z.%20o%20katastru%20nemovitost%ED%20%28katastr%E1ln%ED%20z%E1kon%29
57453,78,1360882800,114,3,26,0,143,A,Vl.n.z.%20o%20katastru%20nemovitost%ED%20%28katastr%E1ln%ED%20z%E1kon%29
57454,79,1360882800,107,0,36,0,143,A,Vl.n.z.o%20zm%u011Bn%u011B%20z%E1k.v%20souvisl.%20s%20p%u0159ij.%20z.%20o%20katastr.%20nemovit.
57455,45,1360882800,87,27,25,6,145,A,Novela%20z.%20o%20rozpo%u010Dtov%E9m%20ur%u010Den%ED%20dan%ED
57456,46,1360882800,120,0,23,0,143,A,Novela%20z.%20o%20loteri%EDch%20a%20jin%FDch%20podobn%FDch%20hr%E1ch
57457,50,1360882800,60,52,2,6,120,R,N.z.%20o%20z%u0159%EDzen%ED%20Krajsk%E9ho%20soudu%20v%20Liberci
57458,50,1360882800,106,7,10,0,123,A,N.z.%20o%20z%u0159%EDzen%ED%20Krajsk%E9ho%20soudu%20v%20Liberci
57459,50,1360882800,65,51,1,6,123,A,N.z.%20o%20z%u0159%EDzen%ED%20Krajsk%E9ho%20soudu%20v%20Liberci
57460,51,1360882800,64,54,3,1,122,A,Novela%20z.%20o%20soudn%EDch%20exekutorech%20a%20exeku%u010Dn%ED%20%u010Dinnosti
57461,52,1360882800,59,50,9,2,120,R,Novela%20z.%20-%20z%E1kon%EDk%20pr%E1ce
57462,52,1360882800,86,20,7,3,116,A,Novela%20z.%20-%20z%E1kon%EDk%20pr%E1ce
57463,52,1360882800,57,59,0,1,117,R,Novela%20z.%20-%20z%E1kon%EDk%20pr%E1ce
57464,52,1360882800,107,5,6,1,119,A,Novela%20z.%20-%20z%E1kon%EDk%20pr%E1ce
57465,52,1360882800,79,24,11,5,119,A,Novela%20z.%20-%20z%E1kon%EDk%20pr%E1ce
57466,53,1360882800,62,45,0,0,107,A,Novela%20z.%20o%20volb%E1ch%20do%20zastupitelstev%20obc%ED
57467,0,1361228400,156,2,8,6,172,A,Po%u0159ad%20sch%u016Fze
57468,0,1361228400,143,3,24,1,171,A,Po%u0159ad%20sch%u016Fze
57469,0,1361228400,154,13,4,2,173,A,Po%u0159ad%20sch%u016Fze
57470,0,1361228400,164,1,8,0,173,A,Po%u0159ad%20sch%u016Fze
57471,0,1361228400,137,14,19,3,173,A,Po%u0159ad%20sch%u016Fze
57472,0,1361228400,99,17,34,23,173,A,Po%u0159ad%20sch%u016Fze
57473,0,1361228400,71,86,10,6,173,R,Po%u0159ad%20sch%u016Fze
57474,0,1361228400,71,88,10,4,173,R,Po%u0159ad%20sch%u016Fze
57475,0,1361228400,72,85,11,5,173,R,Po%u0159ad%20sch%u016Fze
57476,0,1361228400,14,115,34,10,173,R,Po%u0159ad%20sch%u016Fze
57477,0,1361228400,146,3,22,2,173,A,Po%u0159ad%20sch%u016Fze
57478,178,1361228400,143,1,27,2,173,A,Novela%20z.%20o%20azylu%20a%20Policii%20%u010CR%20-%20EU
57479,178,1361228400,155,0,20,1,176,A,Novela%20z.%20o%20azylu%20a%20Policii%20%u010CR%20-%20EU
57480,178,1361228400,161,0,14,1,176,A,Novela%20z.%20o%20azylu%20a%20Policii%20%u010CR%20-%20EU
57481,178,1361228400,162,0,14,1,177,A,Novela%20z.%20o%20azylu%20a%20Policii%20%u010CR%20-%20EU
57482,178,1361228400,121,3,18,35,177,A,Novela%20z.%20o%20azylu%20a%20Policii%20%u010CR%20-%20EU
57483,180,1361228400,126,0,36,10,172,A,N%E1vrh%20na%20odvol%E1n%ED%20%u010Dlena%20DR%20SFDI
57484,133,1361228400,164,0,12,1,177,A,N%E1vrh%20na%20zm%u011Bny%20ve%20slo%u017Een%ED%20org%E1n%u016F%20Poslaneck%E9%20sn%u011Bmovny
57485,133,1361228400,164,0,13,0,177,A,N%E1vrh%20na%20zm%u011Bny%20ve%20slo%u017Een%ED%20org%E1n%u016F%20Poslaneck%E9%20sn%u011Bmovny
57486,135,1361228400,164,1,12,0,177,A,N%E1vrh%20PS%20na%20jmenov%E1n%ED%20%u010Dlena%20Rady%20pro%20rozhlasov%E9%20a%20televizn%ED%20vys%EDl%E1n%ED
57487,136,1361228400,160,0,16,1,177,A,N%E1vrh%20na%20volbu%20%u010Dlena%20Rady%20%u010Cesk%E9ho%20rozhlasu
57488,137,1361228400,156,0,21,0,177,A,N%E1vrh%20na%20volbu%20%u010Dlena%20Rady%20%u010Cesk%E9%20tiskov%E9%20kancel%E1%u0159e
57489,138,1361228400,163,0,15,0,178,A,N%E1vrh%20na%20volbu%20%u010Dlena%20Rady%20%u010Cesk%E9%20televize
57490,139,1361228400,162,1,14,0,177,A,N%E1vrh%20PS%20na%20volbu%20kandid%E1ta%20na%20%u010Dlena%20R%DA%20pro%20studium%20totalitn%EDch%20re%u017Eim%u016F
57491,140,1361228400,160,0,17,0,177,A,N%E1vrh%20na%20volbu%20kandid%E1ta%20do%20funkce%20prezidenta%20NK%DA
57492,142,1361228400,156,0,21,0,177,A,N%E1vrh%20na%20volbu%20%u010Dlen%u016F%20dozor%u010D%ED%20rady%20SFDI
57493,175,1361228400,159,0,19,0,178,A,N%E1vrh%20na%20volbu%20%u010Dlen%u016F%20Dozor%u010D%ED%20rady%20Vina%u0159sk%E9ho%20fondu
57494,179,1361228400,130,33,6,10,179,A,Vl.n.p%u016Fsob.sil%20MO%20ve%20v%FDcvik.misi%20EU%20v%20Malij.rep.%20%28EUTM%20Mali%29
57495,0,1361228400,142,2,32,0,176,A,%20
57496,1,1361228400,21,33,82,37,173,R,Novela%20z.%20o%20Nejvy%u0161%u0161%EDm%20kontroln%EDm%20%FA%u0159adu
57497,1,1361228400,5,81,52,37,175,R,Novela%20z.%20o%20Nejvy%u0161%u0161%EDm%20kontroln%EDm%20%FA%u0159adu
57498,3,1361228400,12,20,134,9,175,R,N.z.o%20zm%u011Bn%u011B%20pr%E1vn%ED%20formy%20ob%u010Dansk%E9ho%20sdru%u017Een%ED
57499,3,1361228400,27,92,27,28,174,R,N.z.o%20zm%u011Bn%u011B%20pr%E1vn%ED%20formy%20ob%u010Dansk%E9ho%20sdru%u017Een%ED
57500,3,1361228400,121,10,19,25,175,A,N.z.o%20zm%u011Bn%u011B%20pr%E1vn%ED%20formy%20ob%u010Dansk%E9ho%20sdru%u017Een%ED
57501,4,1361228400,9,1,164,0,174,R,Vl.n.z.%2Ckter%FDm%20se%20upravuj%ED%20ot%E1zky%20souvis.%20s%20u%u017E%EDv%E1n%EDm%20byt%u016F
57502,4,1361228400,168,0,0,0,168,A,Vl.n.z.%2Ckter%FDm%20se%20upravuj%ED%20ot%E1zky%20souvis.%20s%20u%u017E%EDv%E1n%EDm%20byt%u016F
57503,5,1361228400,64,84,13,9,170,R,Novela%20z.%20o%20zdravotn%EDch%20slu%u017Eb%E1ch
57504,5,1361228400,120,10,15,27,172,A,Novela%20z.%20o%20zdravotn%EDch%20slu%u017Eb%E1ch
57505,6,1361228400,97,34,33,9,173,A,Novela%20z.%20o%20integrovan%E9%20prevenci%20-%20EU
57506,7,1361228400,71,91,7,6,175,R,Novela%20z.%20o%20l%E9%u010Divech%20-%20EU
57507,7,1361228400,100,8,38,28,174,R,Novela%20z.%20o%20l%E9%u010Divech%20-%20EU
57508,7,1361228400,156,6,12,0,174,A,Novela%20z.%20o%20l%E9%u010Divech%20-%20EU
57509,7,1361228400,104,10,33,28,175,A,Novela%20z.%20o%20l%E9%u010Divech%20-%20EU
57510,7,1361228400,163,2,9,0,174,A,Novela%20z.%20o%20l%E9%u010Divech%20-%20EU
57511,7,1361228400,102,12,32,29,175,A,Novela%20z.%20o%20l%E9%u010Divech%20-%20EU
57512,0,1361228400,132,12,22,7,173,A,%20
57513,0,1361228400,133,15,15,8,171,A,%20
57514,127,1361228400,19,134,4,7,164,R,Vl.n.z.o%20opat%u0159en.ke%20zv%FD%u0161en%ED%20transparentnosti%20akciov%FDch%20spol.
57515,127,1361228400,49,91,6,20,166,R,Vl.n.z.o%20opat%u0159en.ke%20zv%FD%u0161en%ED%20transparentnosti%20akciov%FDch%20spol.
57516,127,1361228400,160,0,1,1,162,A,Vl.n.z.o%20opat%u0159en.ke%20zv%FD%u0161en%ED%20transparentnosti%20akciov%FDch%20spol.
57517,0,1363647600,108,0,17,0,125,A,%20
57518,0,1363647600,158,1,21,1,181,A,Po%u0159ad%20sch%u016Fze
57519,0,1363647600,171,0,8,2,181,A,Po%u0159ad%20sch%u016Fze
57520,0,1363647600,176,0,5,1,182,A,Po%u0159ad%20sch%u016Fze
57521,0,1363647600,104,22,34,22,182,A,Po%u0159ad%20sch%u016Fze
57522,0,1363647600,145,1,29,7,182,A,Po%u0159ad%20sch%u016Fze
57523,0,1363647600,92,62,14,14,182,A,Po%u0159ad%20sch%u016Fze
57524,0,1363647600,160,3,19,0,182,A,Po%u0159ad%20sch%u016Fze
57525,0,1363647600,86,70,13,10,179,R,Po%u0159ad%20sch%u016Fze
57526,0,1363647600,163,2,13,3,181,A,Po%u0159ad%20sch%u016Fze
57527,0,1363647600,87,81,9,4,181,R,Po%u0159ad%20sch%u016Fze
57528,0,1363647600,93,79,7,3,182,A,Po%u0159ad%20sch%u016Fze
57529,0,1363647600,157,8,14,2,181,A,Po%u0159ad%20sch%u016Fze
57530,0,1363647600,89,83,6,3,181,R,Po%u0159ad%20sch%u016Fze
57531,0,1363647600,94,56,11,20,181,A,Po%u0159ad%20sch%u016Fze
57532,0,1363647600,56,80,19,26,181,R,Po%u0159ad%20sch%u016Fze
57533,0,1363647600,83,84,10,4,181,R,Po%u0159ad%20sch%u016Fze
57534,0,1363647600,21,80,50,30,181,R,Po%u0159ad%20sch%u016Fze
57535,0,1363647600,94,55,29,3,181,A,Po%u0159ad%20sch%u016Fze
57536,0,1363647600,95,19,38,29,181,A,Po%u0159ad%20sch%u016Fze
57537,0,1363647600,81,89,6,5,181,R,Po%u0159ad%20sch%u016Fze
57538,0,1363647600,144,9,22,6,181,A,Po%u0159ad%20sch%u016Fze
57539,0,1363647600,171,1,8,1,181,A,Po%u0159ad%20sch%u016Fze
57540,0,1363647600,174,2,2,2,180,A,Po%u0159ad%20sch%u016Fze
57541,0,1363647600,164,11,2,3,180,A,Po%u0159ad%20sch%u016Fze
57542,0,1363647600,175,0,2,3,180,A,Po%u0159ad%20sch%u016Fze
57543,0,1363647600,116,15,27,22,180,A,Po%u0159ad%20sch%u016Fze
57544,0,1363647600,136,18,19,7,180,A,Po%u0159ad%20sch%u016Fze
57545,0,1363647600,91,25,42,22,180,A,Po%u0159ad%20sch%u016Fze
57546,0,1363647600,121,17,21,21,180,A,Po%u0159ad%20sch%u016Fze
57547,0,1363647600,132,8,16,24,180,A,Po%u0159ad%20sch%u016Fze
57548,0,1363647600,167,5,3,5,180,A,Po%u0159ad%20sch%u016Fze
57549,0,1363647600,80,78,19,3,180,R,Po%u0159ad%20sch%u016Fze
57550,0,1363647600,127,37,12,4,180,A,Po%u0159ad%20sch%u016Fze
57551,0,1363647600,89,84,5,2,180,R,Po%u0159ad%20sch%u016Fze
57552,0,1363647600,123,11,32,13,179,A,Po%u0159ad%20sch%u016Fze
57553,1,1363647600,111,28,5,5,149,A,Informace%20ministryn%u011B%20pr%E1ce%20a%20soci%E1ln%EDch%20v%u011Bc%ED%20k%20S-kart%E1m
57554,2,1363647600,137,0,32,1,170,A,N%E1vrh%20na%20volbu%20kandid%E1ta%20do%20funkce%20prezidenta%20NK%DA
57555,67,1363647600,114,0,51,0,165,A,Novela%20z.%20-%20insolven%u010Dn%ED%20z%E1kon
57556,67,1363647600,53,63,6,9,131,R,Novela%20z.%20-%20insolven%u010Dn%ED%20z%E1kon
57557,22,1363647600,38,73,18,4,133,R,Novela%20z.%20v%20souv.%20s%20p%u0159ijet%EDm%20rekodifikace%20soukrom%E9ho%20pr%E1va%20-%20EU
57558,22,1363647600,130,0,4,0,134,A,Novela%20z.%20v%20souv.%20s%20p%u0159ijet%EDm%20rekodifikace%20soukrom%E9ho%20pr%E1va%20-%20EU
57559,23,1363647600,109,0,6,1,116,A,Vl.n.z.%20o%20zvl%E1%u0161tn%EDch%20%u0159%EDzen%EDch%20soudn%EDch%20-%20EU
57560,68,1363647600,123,0,15,0,138,A,Novela%20z.%20-%20ob%u010Dansk%FD%20soudn%ED%20%u0159%E1d
57561,66,1363647600,116,0,25,0,141,A,Novela%20z.%20o%20v%FDkonu%20vazby
57562,63,1363734000,132,1,26,2,161,A,Novela%20z.%20o%20d%u016Fchodov%E9m%20poji%u0161t%u011Bn%ED
57563,63,1363734000,127,0,40,0,167,A,Novela%20z.%20o%20d%u016Fchodov%E9m%20poji%u0161t%u011Bn%ED
57564,28,1363734000,121,0,49,0,170,A,Novela%20z.%20o%20kontrole%20obchodu%20s%20v%FDrobky%20-%20EU
57565,29,1363734000,111,0,61,0,172,A,Novela%20z.%20o%20nakl%E1d%E1n%ED%20s%20t%u011B%u017Eebn%EDm%20odpadem%20-%20EU
57566,29,1363734000,98,7,66,2,173,A,Novela%20z.%20o%20nakl%E1d%E1n%ED%20s%20t%u011B%u017Eebn%EDm%20odpadem%20-%20EU
57567,72,1363734000,115,0,57,1,173,A,Novela%20z.%20-%20%u017Eivnostensk%FD%20z%E1kon
57568,24,1363734000,110,0,65,0,175,A,Novela%20z.%20o%20vodovodech%20a%20kanalizac%EDch%20-%20EU
57569,25,1363734000,116,0,60,0,176,A,Novela%20z.o%20%DAst%u0159ed.%20kontroln%EDm%20a%20zku%u0161ebn%EDm%20%FAstavu%20zem%u011Bd%u011Blsk%E9m%20-%20EU
57570,30,1363734000,75,74,2,2,153,R,Novela%20z.%20o%20zam%u011Bstnanosti
57571,30,1363734000,125,15,12,3,155,A,Novela%20z.%20o%20zam%u011Bstnanosti
57572,30,1363734000,79,78,0,0,157,A,Novela%20z.%20o%20zam%u011Bstnanosti
57573,69,1363734000,126,0,39,0,165,A,Novela%20z.%20o%20majetku%20%u010Cesk%E9%20republiky
57574,69,1363734000,74,33,47,11,165,R,Novela%20z.%20o%20majetku%20%u010Cesk%E9%20republiky
57575,70,1363734000,115,0,47,1,163,A,Vl.n.z.%20o%20st%E1tn%EDm%20dluhopisov%E9m%20programu
57576,71,1363734000,116,1,45,1,163,A,Novela%20z.%20o%20st%E1tn%EDm%20rozpo%u010Dtu%20%u010CR%20na%20rok%202013
57577,26,1363734000,134,0,26,0,160,A,Vl.n.z.%20o%20povinn%E9m%20zna%u010Den%ED%20lihu%20-%20EU
57578,26,1363734000,105,13,35,6,159,A,Vl.n.z.%20o%20povinn%E9m%20zna%u010Den%ED%20lihu%20-%20EU
57579,26,1363734000,19,80,49,10,158,R,Vl.n.z.%20o%20povinn%E9m%20zna%u010Den%ED%20lihu%20-%20EU
57580,26,1363734000,29,81,40,7,157,R,Vl.n.z.%20o%20povinn%E9m%20zna%u010Den%ED%20lihu%20-%20EU
57581,27,1363734000,97,0,49,0,146,A,Vl.n.z.%20o%20povinn%E9m%20zna%u010Den%ED%20lihu%20-%20souvisej%EDc%ED
57582,73,1363820400,89,0,23,0,112,A,Prot.proti%20pa%u0161ov%E1n%ED%20p%u0159ist%u011Bhovalc%u016F%20po%20zemi%2C%20po%20mo%u0159i%20a%20letecky
57583,74,1363820400,98,0,20,0,118,A,Prot.%20proti%20nedovolen%E9%20v%FDrob%u011B%20st%u0159eln%FDch%20zbran%ED
57584,75,1363820400,101,0,20,0,121,A,Op%u010Dn%ED%20protokol%20k%20%DAmluv%u011B%20o%20pr%E1vech%20d%EDt%u011Bte
57585,75,1363820400,89,3,27,2,121,A,Op%u010Dn%ED%20protokol%20k%20%DAmluv%u011B%20o%20pr%E1vech%20d%EDt%u011Bte
57586,93,1363820400,102,0,22,0,124,A,Zpr%E1va%20o%20%u010Dinnosti%20a%20hospoda%u0159en%ED%20ER%DA%20za%20rok%202011
57587,94,1363820400,62,4,40,22,128,R,Zpr%E1va%20o%20pln%u011Bn%ED%20st%E1tn%EDho%20rozpo%u010Dtu%20%u010CR%20za%201.%20pololet%ED%202012
57588,95,1363820400,106,0,24,0,130,A,Zpr%E1va%20o%20petic%EDch%20za%20obdob%ED%20od%201.%201.%202012%20do%2030.%206.%202012
57589,96,1363820400,107,0,23,1,131,A,Zpr%E1va%20o%20petic%EDch%20za%20obdob%ED%20od%201.%207.%202012%20do%2031.%2012.%202012
57590,97,1363820400,62,16,44,14,136,R,V%FDro%u010Dn%ED%20zpr%E1vy%20a%20%FA%u010Detn%ED%20z%E1v%u011Brky%20zdr.%20poji%u0161%u0165oven%20za%20rok%202011
57591,97,1363820400,55,49,1,3,108,A,V%FDro%u010Dn%ED%20zpr%E1vy%20a%20%FA%u010Detn%ED%20z%E1v%u011Brky%20zdr.%20poji%u0161%u0165oven%20za%20rok%202011
57592,21,1363906800,100,0,17,1,118,A,Vl.n.z.%20o%20Vojensk%E9%20policii%20-%20EU
57593,21,1363906800,93,2,27,0,122,A,Vl.n.z.%20o%20Vojensk%E9%20policii%20-%20EU
57594,31,1363906800,69,65,5,1,140,R,Novela%20%FAstavn%EDho%20z.%20-%20%DAstava%20%u010Cesk%E9%20republiky
57595,31,1363906800,119,7,17,0,143,A,Novela%20%FAstavn%EDho%20z.%20-%20%DAstava%20%u010Cesk%E9%20republiky
57596,31,1363906800,71,67,3,3,144,R,Novela%20%FAstavn%EDho%20z.%20-%20%DAstava%20%u010Cesk%E9%20republiky
57597,31,1363906800,126,1,15,2,144,A,Novela%20%FAstavn%EDho%20z.%20-%20%DAstava%20%u010Cesk%E9%20republiky
57598,1,1363906800,78,26,12,22,138,A,Informace%20ministryn%u011B%20pr%E1ce%20a%20soci%E1ln%EDch%20v%u011Bc%ED%20k%20s-Kart%E1m
57599,1,1363906800,70,38,8,22,138,A,Informace%20ministryn%u011B%20pr%E1ce%20a%20soci%E1ln%EDch%20v%u011Bc%ED%20k%20s-Kart%E1m
57600,1,1363906800,127,6,3,1,137,A,Informace%20ministryn%u011B%20pr%E1ce%20a%20soci%E1ln%EDch%20v%u011Bc%ED%20k%20s-Kart%E1m
57601,1,1363906800,70,38,7,21,136,A,Informace%20ministryn%u011B%20pr%E1ce%20a%20soci%E1ln%EDch%20v%u011Bc%ED%20k%20s-Kart%E1m
57602,1,1363906800,63,45,7,21,136,R,Informace%20ministryn%u011B%20pr%E1ce%20a%20soci%E1ln%EDch%20v%u011Bc%ED%20k%20s-Kart%E1m
57603,1,1363906800,132,2,2,1,137,A,Informace%20ministryn%u011B%20pr%E1ce%20a%20soci%E1ln%EDch%20v%u011Bc%ED%20k%20s-Kart%E1m
57604,1,1363906800,66,47,6,18,137,R,Informace%20ministryn%u011B%20pr%E1ce%20a%20soci%E1ln%EDch%20v%u011Bc%ED%20k%20s-Kart%E1m
57605,1,1363906800,70,39,9,19,137,A,Informace%20ministryn%u011B%20pr%E1ce%20a%20soci%E1ln%EDch%20v%u011Bc%ED%20k%20s-Kart%E1m
57606,1,1363906800,66,48,8,16,138,R,Informace%20ministryn%u011B%20pr%E1ce%20a%20soci%E1ln%EDch%20v%u011Bc%ED%20k%20s-Kart%E1m
57607,32,1363906800,69,51,2,2,124,A,Novela%20%FAstavn%EDho%20z.%20-%20%DAstava%20%u010Cesk%E9%20republiky
57608,33,1363906800,50,67,6,0,123,R,Novela%20%FAstav.%20z.%20-%20%DAstava%20%u010Cesk%E9%20republiky
57609,33,1363906800,117,1,1,0,119,A,Novela%20%FAstav.%20z.%20-%20%DAstava%20%u010Cesk%E9%20republiky
57610,0,1364252400,81,76,4,1,162,R,Po%u0159ad%20sch%u016Fze
57611,0,1364252400,156,0,8,0,164,A,Po%u0159ad%20sch%u016Fze
57612,0,1364252400,82,77,5,0,164,R,Po%u0159ad%20sch%u016Fze
57613,0,1364252400,160,1,4,0,165,A,Po%u0159ad%20sch%u016Fze
57614,0,1364252400,119,10,23,13,165,A,Po%u0159ad%20sch%u016Fze
57615,0,1364252400,158,0,5,3,166,A,Po%u0159ad%20sch%u016Fze
57616,0,1364252400,160,0,5,1,166,A,Po%u0159ad%20sch%u016Fze
57617,0,1364252400,159,0,6,1,166,A,Po%u0159ad%20sch%u016Fze
57618,0,1364252400,62,74,13,13,162,R,Po%u0159ad%20sch%u016Fze
57619,0,1364252400,76,76,8,5,165,R,Po%u0159ad%20sch%u016Fze
57620,65,1364252400,56,50,37,23,166,R,Novela%20z.%20o%20ochran%u011B%20zem%u011Bd%u011Blsk%E9ho%20p%u016Fdn%EDho%20fondu
57621,65,1364252400,147,2,18,0,167,A,Novela%20z.%20o%20ochran%u011B%20zem%u011Bd%u011Blsk%E9ho%20p%u016Fdn%EDho%20fondu
57622,65,1364252400,142,5,20,0,167,A,Novela%20z.%20o%20ochran%u011B%20zem%u011Bd%u011Blsk%E9ho%20p%u016Fdn%EDho%20fondu
57623,65,1364252400,124,8,34,2,168,A,Novela%20z.%20o%20ochran%u011B%20zem%u011Bd%u011Blsk%E9ho%20p%u016Fdn%EDho%20fondu
57624,61,1364252400,113,0,50,1,164,A,Novela%20z.%20o%20zpravodajsk%FDch%20slu%u017Eb%E1ch%20%u010CR
57625,34,1364252400,121,12,22,2,157,A,Novela%20z.%20-%20%DAstava%20%u010CR
57626,35,1364252400,107,1,46,0,154,A,Novela%20z.%20o%20odpov%u011Bdnosti%20za%20%u0161kodu%20zp%u016Fs.p%u0159i%20v%FDkonu%20ve%u0159ej.moci
57627,36,1364252400,66,53,32,2,153,R,Novela%20z.%20o%20ob%u010Dansk%FDch%20pr%u016Fkazech
57628,36,1364252400,123,1,30,0,154,A,Novela%20z.%20o%20ob%u010Dansk%FDch%20pr%u016Fkazech
57629,37,1364252400,115,1,35,1,152,A,N.z.o%20bezp.pohyb.p%u0159i%20ly%u017E.%2Csnowboard.%20a%20j%EDzd%u011B%20na%20j%EDzdn%EDm%20kole
57630,37,1364252400,78,26,41,7,152,A,N.z.o%20bezp.pohyb.p%u0159i%20ly%u017E.%2Csnowboard.%20a%20j%EDzd%u011B%20na%20j%EDzdn%EDm%20kole
57631,38,1364252400,107,0,39,1,147,A,Vl.n.%FAstav.z.%20o%20celost%E1tn%EDm%20referendu
57632,0,1364338800,75,55,8,21,159,R,Po%u0159ad%20sch%u016Fze
57633,0,1364338800,69,84,6,1,160,R,Po%u0159ad%20sch%u016Fze
57634,0,1364338800,71,61,11,14,157,R,Po%u0159ad%20sch%u016Fze
57635,0,1364338800,149,5,5,0,159,A,Po%u0159ad%20sch%u016Fze
57636,0,1364338800,78,58,6,12,154,A,Po%u0159ad%20sch%u016Fze
57637,90,1364338800,142,0,17,0,159,A,Novela%20z.%20-%20z%E1kon%EDk%20pr%E1ce
57638,90,1364338800,8,142,9,1,160,R,Novela%20z.%20-%20z%E1kon%EDk%20pr%E1ce
57639,90,1364338800,100,23,22,15,160,A,Novela%20z.%20-%20z%E1kon%EDk%20pr%E1ce
57640,90,1364338800,9,143,7,1,160,R,Novela%20z.%20-%20z%E1kon%EDk%20pr%E1ce
57641,90,1364338800,124,23,9,4,160,A,Novela%20z.%20-%20z%E1kon%EDk%20pr%E1ce
57642,77,1364338800,71,78,9,2,160,R,Novela%20z.%20o%20nouzov%FDch%20z%E1sob%E1ch%20ropy%20-%20EU
57643,77,1364338800,102,6,34,17,159,A,Novela%20z.%20o%20nouzov%FDch%20z%E1sob%E1ch%20ropy%20-%20EU
57644,77,1364338800,105,16,29,9,159,A,Novela%20z.%20o%20nouzov%FDch%20z%E1sob%E1ch%20ropy%20-%20EU
57645,77,1364338800,81,44,29,5,159,A,Novela%20z.%20o%20nouzov%FDch%20z%E1sob%E1ch%20ropy%20-%20EU
57646,78,1364338800,110,5,34,11,160,A,Vl.n.z.%20o%20mezin%E1rodn%ED%20spolupr%E1ci%20p%u0159i%20spr%E1v%u011B%20dan%ED%20-%20EU
57647,78,1364338800,119,3,24,14,160,A,Vl.n.z.%20o%20mezin%E1rodn%ED%20spolupr%E1ci%20p%u0159i%20spr%E1v%u011B%20dan%ED%20-%20EU
57648,79,1364338800,117,4,25,13,159,A,Novela%20z.%20-%20obchodn%ED%20z%E1kon%EDk%20-%20EU
57649,79,1364338800,110,5,24,21,160,A,Novela%20z.%20-%20obchodn%ED%20z%E1kon%EDk%20-%20EU
57650,80,1364338800,145,0,13,1,159,A,Novela%20z.%20o%20st%u0159eln%FDch%20zbran%EDch%20-%20EU
57651,80,1364338800,150,0,7,1,158,A,Novela%20z.%20o%20st%u0159eln%FDch%20zbran%EDch%20-%20EU
57652,80,1364338800,11,134,10,3,158,R,Novela%20z.%20o%20st%u0159eln%FDch%20zbran%EDch%20-%20EU
57653,80,1364338800,146,0,10,2,158,A,Novela%20z.%20o%20st%u0159eln%FDch%20zbran%EDch%20-%20EU
57654,0,1364338800,142,1,14,0,157,A,%20
57655,82,1364338800,117,2,32,4,155,A,Novela%20z.%20o%20insolven%u010Dn%EDch%20spr%E1vc%EDch
57656,82,1364338800,77,14,42,22,155,R,Novela%20z.%20o%20insolven%u010Dn%EDch%20spr%E1vc%EDch
57657,82,1364338800,126,0,10,1,137,A,Novela%20z.%20o%20insolven%u010Dn%EDch%20spr%E1vc%EDch
57658,82,1364338800,77,16,26,23,142,A,Novela%20z.%20o%20insolven%u010Dn%EDch%20spr%E1vc%EDch
57659,82,1364338800,108,4,12,19,143,A,Novela%20z.%20o%20insolven%u010Dn%EDch%20spr%E1vc%EDch
57660,83,1364338800,50,88,6,2,146,R,Novela%20z.%20o%20poji%u0161%u0165ovnictv%ED
57661,83,1364338800,73,71,4,1,149,R,Novela%20z.%20o%20poji%u0161%u0165ovnictv%ED
57668,83,1364338800,121,1,2,6,130,A,Novela%20z.%20o%20poji%u0161%u0165ovnictv%ED
57669,83,1364338800,114,9,9,5,137,A,Novela%20z.%20o%20poji%u0161%u0165ovnictv%ED
57670,83,1364338800,117,10,5,5,137,A,Novela%20z.%20o%20poji%u0161%u0165ovnictv%ED
57671,83,1364338800,14,107,7,9,137,R,Novela%20z.%20o%20poji%u0161%u0165ovnictv%ED
57672,83,1364338800,88,34,5,5,132,A,Novela%20z.%20o%20poji%u0161%u0165ovnictv%ED
57673,85,1364338800,114,0,26,0,140,A,Novela%20z.o%20vy%u0161%u0161%EDch%20soud.%FA%u0159edn%EDc%EDch%20a%20vy%u0161%u0161%EDch%20%FA%u0159ed.st%E1t.zast.
57674,85,1364338800,120,1,21,0,142,A,Novela%20z.o%20vy%u0161%u0161%EDch%20soud.%FA%u0159edn%EDc%EDch%20a%20vy%u0161%u0161%EDch%20%FA%u0159ed.st%E1t.zast.
57675,86,1364338800,126,0,17,1,144,A,Vl.n.z.%20o%20st%E1tn%EDm%20ob%u010Danstv%ED%20%u010Cesk%E9%20republiky
57676,86,1364338800,9,0,135,0,144,R,Vl.n.z.%20o%20st%E1tn%EDm%20ob%u010Danstv%ED%20%u010Cesk%E9%20republiky
57677,86,1364338800,133,0,11,0,144,A,Vl.n.z.%20o%20st%E1tn%EDm%20ob%u010Danstv%ED%20%u010Cesk%E9%20republiky
57678,86,1364338800,111,0,30,3,144,A,Vl.n.z.%20o%20st%E1tn%EDm%20ob%u010Danstv%ED%20%u010Cesk%E9%20republiky
57679,86,1364338800,133,0,11,0,144,A,Vl.n.z.%20o%20st%E1tn%EDm%20ob%u010Danstv%ED%20%u010Cesk%E9%20republiky
57680,86,1364338800,80,25,36,2,143,A,Vl.n.z.%20o%20st%E1tn%EDm%20ob%u010Danstv%ED%20%u010Cesk%E9%20republiky
57681,86,1364338800,125,9,10,0,144,A,Vl.n.z.%20o%20st%E1tn%EDm%20ob%u010Danstv%ED%20%u010Cesk%E9%20republiky
57682,86,1364338800,77,47,16,4,144,A,Vl.n.z.%20o%20st%E1tn%EDm%20ob%u010Danstv%ED%20%u010Cesk%E9%20republiky
57683,86,1364338800,130,0,12,2,144,A,Vl.n.z.%20o%20st%E1tn%EDm%20ob%u010Danstv%ED%20%u010Cesk%E9%20republiky
57684,86,1364338800,11,98,30,6,145,R,Vl.n.z.%20o%20st%E1tn%EDm%20ob%u010Danstv%ED%20%u010Cesk%E9%20republiky
57685,86,1364338800,10,123,10,2,145,R,Vl.n.z.%20o%20st%E1tn%EDm%20ob%u010Danstv%ED%20%u010Cesk%E9%20republiky
57686,86,1364338800,9,123,10,2,144,R,Vl.n.z.%20o%20st%E1tn%EDm%20ob%u010Danstv%ED%20%u010Cesk%E9%20republiky
57687,86,1364338800,10,124,10,0,144,R,Vl.n.z.%20o%20st%E1tn%EDm%20ob%u010Danstv%ED%20%u010Cesk%E9%20republiky
57688,86,1364338800,9,123,10,2,144,R,Vl.n.z.%20o%20st%E1tn%EDm%20ob%u010Danstv%ED%20%u010Cesk%E9%20republiky
57689,86,1364338800,133,1,10,0,144,A,Vl.n.z.%20o%20st%E1tn%EDm%20ob%u010Danstv%ED%20%u010Cesk%E9%20republiky
57690,86,1364338800,132,0,11,1,144,A,Vl.n.z.%20o%20st%E1tn%EDm%20ob%u010Danstv%ED%20%u010Cesk%E9%20republiky
57691,87,1364338800,113,0,28,0,141,A,Novela%20z.%20o%20cestovn%EDch%20dokladech
57692,89,1364338800,113,0,25,5,143,A,N.z.%20o%20%u010Cesk%E9m%20n%E1rodn%EDm%20povst%E1n%ED
57693,89,1364338800,54,70,19,2,145,R,N.z.%20o%20%u010Cesk%E9m%20n%E1rodn%EDm%20povst%E1n%ED
57694,89,1364338800,90,33,18,3,144,A,N.z.%20o%20%u010Cesk%E9m%20n%E1rodn%EDm%20povst%E1n%ED
57695,89,1364338800,117,6,17,2,142,A,N.z.%20o%20%u010Cesk%E9m%20n%E1rodn%EDm%20povst%E1n%ED
57696,0,1364940000,20,96,39,28,183,R,Po%u0159ad%20sch%u016Fze
57697,0,1364940000,100,72,9,2,183,A,Po%u0159ad%20sch%u016Fze
57698,110,1364940000,170,1,12,0,183,A,N%E1vrh%20na%20volbu%20kandid%E1ta%20viceprezidenta%20NK%DA
57699,84,1364940000,156,0,26,1,183,A,Novela%20z.%20o%20V%u011Bze%u0148sk%E9%20slu%u017Eb%u011B%20a%20justi%u010Dn%ED%20str%E1%u017Ei%20%u010CR
57700,84,1364940000,33,125,3,2,163,R,Novela%20z.%20o%20V%u011Bze%u0148sk%E9%20slu%u017Eb%u011B%20a%20justi%u010Dn%ED%20str%E1%u017Ei%20%u010CR
57701,84,1364940000,161,0,3,2,166,A,Novela%20z.%20o%20V%u011Bze%u0148sk%E9%20slu%u017Eb%u011B%20a%20justi%u010Dn%ED%20str%E1%u017Ei%20%u010CR
57702,84,1364940000,167,1,1,0,169,A,Novela%20z.%20o%20V%u011Bze%u0148sk%E9%20slu%u017Eb%u011B%20a%20justi%u010Dn%ED%20str%E1%u017Ei%20%u010CR
57703,84,1364940000,168,1,1,2,172,A,Novela%20z.%20o%20V%u011Bze%u0148sk%E9%20slu%u017Eb%u011B%20a%20justi%u010Dn%ED%20str%E1%u017Ei%20%u010CR
57704,88,1364940000,172,0,5,0,177,A,Novela%20z.%20o%20st%E1tn%EDch%20sv%E1tc%EDch
57705,88,1364940000,22,102,28,25,177,R,Novela%20z.%20o%20st%E1tn%EDch%20sv%E1tc%EDch
57706,88,1364940000,23,99,31,24,177,R,Novela%20z.%20o%20st%E1tn%EDch%20sv%E1tc%EDch
57707,88,1364940000,60,100,7,10,177,R,Novela%20z.%20o%20st%E1tn%EDch%20sv%E1tc%EDch
57708,88,1364940000,149,6,18,3,176,A,Novela%20z.%20o%20st%E1tn%EDch%20sv%E1tc%EDch
57709,91,1364940000,90,33,16,21,160,A,Novela%20z.%20o%20loteri%EDch
57710,109,1364940000,168,1,4,1,174,A,Novela%20z.%20o%20nakl%E1d%E1n%ED%20s%20t%u011B%u017Eebn%EDm%20odpadem%20-%20EU
57711,109,1364940000,128,10,11,26,175,A,Novela%20z.%20o%20nakl%E1d%E1n%ED%20s%20t%u011B%u017Eebn%EDm%20odpadem%20-%20EU
57712,112,1364940000,150,0,28,0,178,A,N%E1vrh%20na%20jmenov%E1n%ED%20%u010Dlen%u016F%20KR%20TA%20%u010CR
57713,112,1364940000,147,0,31,0,178,A,N%E1vrh%20na%20jmenov%E1n%ED%20%u010Dlen%u016F%20KR%20TA%20%u010CR
57714,113,1364940000,149,1,28,0,178,A,N%E1vrh%20na%20volbu%20%u010Dlena%20Nejvy%u0161%u0161%EDho%20kontroln%EDho%20%FA%u0159adu
57715,113,1364940000,153,0,25,0,178,A,N%E1vrh%20na%20volbu%20%u010Dlena%20Nejvy%u0161%u0161%EDho%20kontroln%EDho%20%FA%u0159adu
57716,113,1364940000,79,39,47,11,176,R,N%E1vrh%20na%20volbu%20%u010Dlena%20Nejvy%u0161%u0161%EDho%20kontroln%EDho%20%FA%u0159adu
57717,113,1364940000,139,4,31,3,177,A,N%E1vrh%20na%20volbu%20%u010Dlena%20Nejvy%u0161%u0161%EDho%20kontroln%EDho%20%FA%u0159adu
57718,0,1364940000,106,41,6,5,158,A,%20
57719,0,1367877600,126,1,35,0,162,A,%20
57720,0,1367877600,151,0,19,2,172,A,Po%u0159ad%20sch%u016Fze
57721,0,1367877600,115,13,28,16,172,A,Po%u0159ad%20sch%u016Fze
57722,0,1367877600,118,18,19,17,172,A,Po%u0159ad%20sch%u016Fze
57723,0,1367877600,75,76,15,8,174,R,Po%u0159ad%20sch%u016Fze
57724,0,1367877600,77,77,14,6,174,R,Po%u0159ad%20sch%u016Fze
57725,0,1367877600,78,84,9,4,175,R,Po%u0159ad%20sch%u016Fze
57726,0,1367877600,72,83,17,3,175,R,Po%u0159ad%20sch%u016Fze
57727,0,1367877600,88,32,39,15,174,A,Po%u0159ad%20sch%u016Fze
57728,0,1367877600,89,42,39,5,175,A,Po%u0159ad%20sch%u016Fze
57729,0,1367877600,89,24,39,23,175,A,Po%u0159ad%20sch%u016Fze
57730,0,1367877600,122,15,19,20,176,A,Po%u0159ad%20sch%u016Fze
57731,0,1367877600,152,11,8,5,176,A,Po%u0159ad%20sch%u016Fze
57732,0,1367877600,135,3,33,6,177,A,Po%u0159ad%20sch%u016Fze
57733,0,1367877600,134,10,29,4,177,A,Po%u0159ad%20sch%u016Fze
57734,0,1367877600,112,45,16,4,177,A,Po%u0159ad%20sch%u016Fze
57735,0,1367877600,124,12,22,19,177,A,Po%u0159ad%20sch%u016Fze
57736,0,1367877600,162,0,15,0,177,A,Po%u0159ad%20sch%u016Fze
57737,0,1367877600,94,22,45,16,177,A,Po%u0159ad%20sch%u016Fze
57738,0,1367877600,98,19,39,21,177,A,Po%u0159ad%20sch%u016Fze
57739,0,1367877600,160,1,15,1,177,A,Po%u0159ad%20sch%u016Fze
57740,0,1367877600,96,17,47,17,177,A,Po%u0159ad%20sch%u016Fze
57741,0,1367877600,38,113,18,8,177,R,Po%u0159ad%20sch%u016Fze
57742,0,1367877600,66,81,22,5,174,R,Po%u0159ad%20sch%u016Fze
57743,0,1367877600,67,70,28,12,177,R,Po%u0159ad%20sch%u016Fze
57744,0,1367877600,57,65,37,18,177,R,Po%u0159ad%20sch%u016Fze
57745,0,1367877600,144,4,29,0,177,A,Po%u0159ad%20sch%u016Fze
57746,0,1367877600,74,75,15,13,177,R,Po%u0159ad%20sch%u016Fze
57747,0,1367877600,93,20,39,25,177,A,Po%u0159ad%20sch%u016Fze
57748,1,1367877600,123,3,4,7,137,A,Novela%20z.%20o%20odpadech%20-%20EU
57749,1,1367877600,133,3,1,15,152,A,Novela%20z.%20o%20odpadech%20-%20EU
57750,0,1367877600,123,1,24,4,152,A,%20
57751,6,1367877600,81,61,8,5,155,A,Vl.n.z.o%20opat%u0159en.ke%20zv%FD%u0161en%ED%20transparentnosti%20akciov%FDch%20spol.
57752,6,1367877600,137,9,11,5,162,A,Vl.n.z.o%20opat%u0159en.ke%20zv%FD%u0161en%ED%20transparentnosti%20akciov%FDch%20spol.
57753,6,1367877600,80,68,7,6,161,R,Vl.n.z.o%20opat%u0159en.ke%20zv%FD%u0161en%ED%20transparentnosti%20akciov%FDch%20spol.
57754,6,1367877600,158,0,2,2,162,A,Vl.n.z.o%20opat%u0159en.ke%20zv%FD%u0161en%ED%20transparentnosti%20akciov%FDch%20spol.
57755,164,1368050400,42,41,6,0,89,R,""
57756,164,1368050400,42,44,4,0,90,R,P%EDsemn%E1%20interpelace%20I.%20Ohl%EDdala%20na%20P.%20Ne%u010Dase%20ve%20v%u011Bci%20pravidel%20t%FDkaj%EDc%ED
57757,164,1368050400,43,44,1,2,90,R,P%EDsemn%E1%20interpelace%20J.%20Paroubka%20na%20P.%20Ne%u010Dase%20ve%20v%u011Bci%20da%u0148ov%FDch%20%FAnik%u016F%20na
57758,164,1368050400,35,43,25,0,103,R,P%EDsemn%E1%20interpelace%20B.%20Petra%20na%20P.%20Ne%u010Dase%20ve%20v%u011Bci%20trval%E9ho%20r%u016Fstu%20cen%20e
57759,164,1368050400,38,50,19,0,107,R,P%EDsemn%E1%20interpelace%20M.%20V%E1ni%20na%20P.%20Ne%u010Dase%20ve%20v%u011Bci%20vl%E1dn%EDho%20stabil.%20bal%ED
57760,164,1368050400,42,45,23,0,110,R,P%EDsemn%E1%20interpelace%20I.%20Ohl%EDdala%20na%20P.%20Fialu%20ve%20v%u011Bci%20krize%20praktick%FDch
57761,164,1368050400,48,46,21,0,115,R,P%EDsemn%E1%20interpelace%20V.%20Filipa%20na%20Z.%20Stanjuru%20ve%20v%u011Bci%20v%FDb%u011Br.%20%u0159%EDz.%20na%20fu
57762,2,1368050400,33,46,19,5,103,R,Vl.n.z.%20o%20N%E1rodn%EDm%20parku%20%u0160umava
57763,2,1368050400,45,25,25,9,104,R,Vl.n.z.%20o%20N%E1rodn%EDm%20parku%20%u0160umava
57764,2,1368050400,35,28,26,15,104,R,Vl.n.z.%20o%20N%E1rodn%EDm%20parku%20%u0160umava
57765,2,1368050400,103,0,1,2,106,A,Vl.n.z.%20o%20N%E1rodn%EDm%20parku%20%u0160umava
57766,2,1368050400,89,9,4,3,105,A,Vl.n.z.%20o%20N%E1rodn%EDm%20parku%20%u0160umava
57767,2,1368050400,89,9,4,5,107,A,Vl.n.z.%20o%20N%E1rodn%EDm%20parku%20%u0160umava
57768,2,1368050400,37,52,9,9,107,R,Vl.n.z.%20o%20N%E1rodn%EDm%20parku%20%u0160umava
57769,0,1368136800,131,0,6,0,137,A,Po%u0159ad%20sch%u016Fze
57770,0,1368136800,134,0,6,0,140,A,Po%u0159ad%20sch%u016Fze
57771,0,1368136800,71,21,31,18,141,A,Po%u0159ad%20sch%u016Fze
57772,44,1368136800,131,0,17,0,148,A,Novela%20z.%20o%20silni%u010Dn%EDm%20provozu%20-%20EU
57773,89,1368136800,120,0,26,0,146,A,Novela%20z.%20o%20pozemn%EDch%20komunikac%EDch
57774,45,1368136800,121,0,28,0,149,A,Vl.n.z.o%20ve%u0159ejn%FDch%20rejst%u0159%EDc%EDch%20pr%E1vnick%FDch%20a%20fyzick%FDch%20osob%20-%20EU
57775,45,1368136800,88,22,31,9,150,A,Vl.n.z.o%20ve%u0159ejn%FDch%20rejst%u0159%EDc%EDch%20pr%E1vnick%FDch%20a%20fyzick%FDch%20osob%20-%20EU
57776,45,1368136800,71,41,36,2,150,R,Vl.n.z.o%20ve%u0159ejn%FDch%20rejst%u0159%EDc%EDch%20pr%E1vnick%FDch%20a%20fyzick%FDch%20osob%20-%20EU
57777,45,1368136800,114,4,30,2,150,A,Vl.n.z.o%20ve%u0159ejn%FDch%20rejst%u0159%EDc%EDch%20pr%E1vnick%FDch%20a%20fyzick%FDch%20osob%20-%20EU
57778,45,1368136800,70,47,8,2,127,A,Vl.n.z.o%20ve%u0159ejn%FDch%20rejst%u0159%EDc%EDch%20pr%E1vnick%FDch%20a%20fyzick%FDch%20osob%20-%20EU
57779,40,1368136800,118,0,26,4,148,A,Novela%20z.%20o%20soudn%EDch%20poplatc%EDch
57780,40,1368136800,131,1,18,0,150,A,Novela%20z.%20o%20soudn%EDch%20poplatc%EDch
57781,40,1368136800,135,2,12,1,150,A,Novela%20z.%20o%20soudn%EDch%20poplatc%EDch
57782,84,1368136800,41,78,30,1,150,R,Vl.n.z.%20o%20statusu%20ve%u0159ejn%E9%20prosp%u011B%u0161nosti
57783,84,1368136800,133,1,16,0,150,A,Vl.n.z.%20o%20statusu%20ve%u0159ejn%E9%20prosp%u011B%u0161nosti
57784,84,1368136800,1,4,145,0,150,R,Vl.n.z.%20o%20statusu%20ve%u0159ejn%E9%20prosp%u011B%u0161nosti
57785,84,1368136800,72,62,3,1,138,A,Vl.n.z.%20o%20statusu%20ve%u0159ejn%E9%20prosp%u011B%u0161nosti
57786,84,1368136800,125,2,12,0,139,A,Vl.n.z.%20o%20statusu%20ve%u0159ejn%E9%20prosp%u011B%u0161nosti
57787,84,1368136800,72,64,5,0,141,A,Vl.n.z.%20o%20statusu%20ve%u0159ejn%E9%20prosp%u011B%u0161nosti
57788,46,1368136800,112,0,28,1,141,A,Novela%20z.%20-%20trestn%ED%20z%E1kon%EDk%20-%20EU
57789,9,1368136800,86,0,54,2,142,A,Novela%20z.%20o%20obchodu%20s%20reproduk%u010Dn%EDm%20materi%E1lem%20lesn%EDch%20d%u0159evin%20-%20EU
57790,34,1368136800,77,0,1,1,79,A,Novela%20z.%20o%20st%E1tn%ED%20soci%E1ln%ED%20podpo%u0159e
57791,0,1368482400,140,0,8,1,149,A,Po%u0159ad%20sch%u016Fze
57792,0,1368482400,23,73,30,26,152,R,Po%u0159ad%20sch%u016Fze
57793,0,1368482400,148,1,5,1,155,A,Po%u0159ad%20sch%u016Fze
57794,0,1368482400,75,73,7,0,155,R,Po%u0159ad%20sch%u016Fze
57795,0,1368482400,80,17,37,21,155,A,Po%u0159ad%20sch%u016Fze
57796,0,1368482400,84,41,24,8,157,A,Po%u0159ad%20sch%u016Fze
57797,0,1368482400,84,20,35,18,157,A,Po%u0159ad%20sch%u016Fze
57798,0,1368482400,124,24,6,3,157,A,Po%u0159ad%20sch%u016Fze
57799,0,1368482400,138,5,12,2,157,A,Po%u0159ad%20sch%u016Fze
57800,0,1368482400,82,52,15,8,157,A,Po%u0159ad%20sch%u016Fze
57801,0,1368482400,71,46,31,9,157,R,Po%u0159ad%20sch%u016Fze
57802,0,1368482400,77,65,12,3,157,R,Po%u0159ad%20sch%u016Fze
57803,0,1368482400,142,2,10,3,157,A,Po%u0159ad%20sch%u016Fze
57804,0,1368482400,78,72,4,1,155,A,Po%u0159ad%20sch%u016Fze
57805,0,1368482400,79,21,36,19,155,A,Po%u0159ad%20sch%u016Fze
57806,0,1368482400,60,26,40,28,154,R,Po%u0159ad%20sch%u016Fze
57807,0,1368482400,130,4,20,2,156,A,Po%u0159ad%20sch%u016Fze
57808,0,1368482400,77,28,33,18,156,R,Po%u0159ad%20sch%u016Fze
57809,3,1368482400,3,71,49,32,155,R,Novela%20z.%20o%20odpadech%20-%20EU
57810,3,1368482400,86,29,37,3,155,A,Novela%20z.%20o%20odpadech%20-%20EU
57811,3,1368482400,1,103,21,30,155,R,Novela%20z.%20o%20odpadech%20-%20EU
57812,91,1368482400,11,124,10,3,148,R,N.z.%2C%20kter%FDm%20se%20zru%u0161uje%20karta%20soci%E1ln%EDch%20syst%E9m%u016F
57813,91,1368482400,33,85,14,10,142,R,N.z.%2C%20kter%FDm%20se%20zru%u0161uje%20karta%20soci%E1ln%EDch%20syst%E9m%u016F
57814,91,1368482400,136,1,8,1,146,A,N.z.%2C%20kter%FDm%20se%20zru%u0161uje%20karta%20soci%E1ln%EDch%20syst%E9m%u016F
57815,91,1368482400,72,2,69,1,144,R,N.z.%2C%20kter%FDm%20se%20zru%u0161uje%20karta%20soci%E1ln%EDch%20syst%E9m%u016F
57816,91,1368482400,116,5,6,10,137,A,N.z.%2C%20kter%FDm%20se%20zru%u0161uje%20karta%20soci%E1ln%EDch%20syst%E9m%u016F
57817,7,1368482400,74,51,15,7,147,A,Novela%20z.%20-%20autorsk%FD%20z%E1kon
57818,7,1368482400,111,6,18,3,138,A,Novela%20z.%20-%20autorsk%FD%20z%E1kon
57819,7,1368482400,78,50,6,6,140,A,Novela%20z.%20-%20autorsk%FD%20z%E1kon
57820,27,1368482400,51,24,47,6,128,R,Vl.n.z.%20o%20katastru%20nemovitost%ED%20%28katastr%E1ln%ED%20z%E1kon%29
57821,27,1368482400,95,0,5,0,100,A,Vl.n.z.%20o%20katastru%20nemovitost%ED%20%28katastr%E1ln%ED%20z%E1kon%29
57822,27,1368482400,55,26,15,4,100,A,Vl.n.z.%20o%20katastru%20nemovitost%ED%20%28katastr%E1ln%ED%20z%E1kon%29
57823,28,1368482400,54,22,21,2,99,A,Vl.n.z.o%20zm%u011Bn%u011B%20z%E1k.v%20souvisl.%20s%20p%u0159ij.%20z.%20o%20katastr.%20nemovit.
57824,0,1368568800,114,0,24,2,140,A,Po%u0159ad%20sch%u016Fze
57825,0,1368568800,114,0,22,6,142,A,Po%u0159ad%20sch%u016Fze
57826,0,1368568800,40,36,38,30,144,R,Po%u0159ad%20sch%u016Fze
57827,0,1368568800,136,1,7,0,144,A,Po%u0159ad%20sch%u016Fze
57828,0,1368568800,137,1,5,2,145,A,Po%u0159ad%20sch%u016Fze
57829,0,1368568800,79,39,24,5,147,A,Po%u0159ad%20sch%u016Fze
57830,0,1368568800,143,0,5,0,148,A,Po%u0159ad%20sch%u016Fze
57831,138,1368568800,8,92,34,18,152,R,Novela%20z.%20o%20elektronick%FDch%20komunikac%EDch
57832,138,1368568800,114,0,29,12,155,A,Novela%20z.%20o%20elektronick%FDch%20komunikac%EDch
57833,138,1368568800,147,0,7,2,156,A,Novela%20z.%20o%20elektronick%FDch%20komunikac%EDch
57834,138,1368568800,83,10,35,23,151,A,Novela%20z.%20o%20elektronick%FDch%20komunikac%EDch
57835,132,1368568800,43,99,12,3,157,R,Novela%20z.%20o%20po%u0161tovn%EDch%20slu%u017Eb%E1ch
57836,132,1368568800,145,2,9,1,157,A,Novela%20z.%20o%20po%u0161tovn%EDch%20slu%u017Eb%E1ch
57837,132,1368568800,103,31,10,12,156,A,Novela%20z.%20o%20po%u0161tovn%EDch%20slu%u017Eb%E1ch
57838,125,1368568800,145,0,11,1,157,A,Novela%20z.%20o%20ochran%u011B%20ve%u0159ejn%E9ho%20zdrav%ED%20-%20EU
57839,116,1368568800,144,0,14,1,159,A,Novela%20z.%20o%20obchodu%20s%20reproduk%u010Dn%EDm%20materi%E1lem%20lesn%EDch%20d%u0159evin%20-%20EU
57840,116,1368568800,144,0,15,0,159,A,Novela%20z.%20o%20obchodu%20s%20reproduk%u010Dn%EDm%20materi%E1lem%20lesn%EDch%20d%u0159evin%20-%20EU
57841,116,1368568800,143,0,16,1,160,A,Novela%20z.%20o%20obchodu%20s%20reproduk%u010Dn%EDm%20materi%E1lem%20lesn%EDch%20d%u0159evin%20-%20EU
57842,118,1368568800,60,2,94,0,156,R,Novela%20z.o%20podm%EDn.%20provozu%20vozidel%20na%20pozemn%EDch%20komunikac%EDch%20-%20EU
57843,118,1368568800,113,5,36,3,157,A,Novela%20z.o%20podm%EDn.%20provozu%20vozidel%20na%20pozemn%EDch%20komunikac%EDch%20-%20EU
57844,118,1368568800,3,92,43,21,159,R,Novela%20z.o%20podm%EDn.%20provozu%20vozidel%20na%20pozemn%EDch%20komunikac%EDch%20-%20EU
57845,118,1368568800,63,79,16,1,159,R,Novela%20z.o%20podm%EDn.%20provozu%20vozidel%20na%20pozemn%EDch%20komunikac%EDch%20-%20EU
57846,118,1368568800,73,72,13,1,159,R,Novela%20z.o%20podm%EDn.%20provozu%20vozidel%20na%20pozemn%EDch%20komunikac%EDch%20-%20EU
57847,118,1368568800,147,0,12,1,160,A,Novela%20z.o%20podm%EDn.%20provozu%20vozidel%20na%20pozemn%EDch%20komunikac%EDch%20-%20EU
57848,118,1368568800,103,15,23,18,159,A,Novela%20z.o%20podm%EDn.%20provozu%20vozidel%20na%20pozemn%EDch%20komunikac%EDch%20-%20EU
57849,120,1368568800,131,0,26,1,158,A,Vl.n.z.%20o%20uv%E1d%u011Bn%ED%20d%u0159eva%20a%20d%u0159eva%u0159sk%FDch%20v%FDrobk%u016F%20na%20trh%20-%20EU
57850,120,1368568800,109,8,24,19,160,A,Vl.n.z.%20o%20uv%E1d%u011Bn%ED%20d%u0159eva%20a%20d%u0159eva%u0159sk%FDch%20v%FDrobk%u016F%20na%20trh%20-%20EU
57851,126,1368568800,135,0,23,1,159,A,Novela%20z.%20o%20finan%u010Dn%EDch%20konglomer%E1tech%20-%20EU
57852,127,1368568800,127,0,30,3,160,A,Vl.n.z.%20o%20investi%u010Dn%EDch%20spole%u010Dnostech%20a%20investi%u010Dn%EDch%20fondech%20-%20EU
57853,127,1368568800,102,13,28,19,162,A,Vl.n.z.%20o%20investi%u010Dn%EDch%20spole%u010Dnostech%20a%20investi%u010Dn%EDch%20fondech%20-%20EU
57854,128,1368568800,135,1,23,2,161,A,Vl.n.z.%20o%20investi%u010Dn%EDch%20spol.%20a%20inv.%20fondech%20-%20souvisej%EDc%ED%20-%20EU
57855,128,1368568800,140,0,19,2,161,A,Vl.n.z.%20o%20investi%u010Dn%EDch%20spol.%20a%20inv.%20fondech%20-%20souvisej%EDc%ED%20-%20EU
57856,128,1368568800,104,10,29,18,161,A,Vl.n.z.%20o%20investi%u010Dn%EDch%20spol.%20a%20inv.%20fondech%20-%20souvisej%EDc%ED%20-%20EU
57857,129,1368568800,100,13,34,14,161,A,Novela%20z.%20o%20zm%EDrn%u011Bn%ED%20n%E1sledk%u016F%20n%u011Bkter%FDch%20majetkov%FDch%20k%u0159ivd
57858,131,1368568800,101,13,31,15,160,A,Novela%20z.%20o%20poji%u0161%u0165ov%E1n%ED%20a%20fin.%20v%FDvozu%20se%20st%E1tn%ED%20podporou
57859,131,1368568800,98,26,24,12,160,A,Novela%20z.%20o%20poji%u0161%u0165ov%E1n%ED%20a%20fin.%20v%FDvozu%20se%20st%E1tn%ED%20podporou
57860,133,1368568800,130,2,26,3,161,A,Novela%20z.%20o%20st%E1tn%EDm%20podniku
57861,133,1368568800,128,8,21,4,161,A,Novela%20z.%20o%20st%E1tn%EDm%20podniku
57862,133,1368568800,82,17,42,20,161,A,Novela%20z.%20o%20st%E1tn%EDm%20podniku
57863,133,1368568800,139,1,4,0,144,A,Novela%20z.%20o%20st%E1tn%EDm%20podniku
57864,133,1368568800,82,21,33,12,148,A,Novela%20z.%20o%20st%E1tn%EDm%20podniku
57865,136,1368568800,137,1,16,0,154,A,Novela%20z.%20o%20silni%u010Dn%EDm%20provozu
57866,136,1368568800,145,0,10,0,155,A,Novela%20z.%20o%20silni%u010Dn%EDm%20provozu
57867,139,1368568800,139,1,12,3,155,A,Novela%20z.%20o%20loteri%EDch%20a%20jin%FDch%20podobn%FDch%20hr%E1ch
57868,139,1368568800,10,80,46,19,155,R,Novela%20z.%20o%20loteri%EDch%20a%20jin%FDch%20podobn%FDch%20hr%E1ch
57869,139,1368568800,134,3,10,4,151,A,Novela%20z.%20o%20loteri%EDch%20a%20jin%FDch%20podobn%FDch%20hr%E1ch
57870,140,1368568800,2,131,18,3,154,R,Vl.%20n.%20z.%20o%20nakl%E1d%E1n%ED%20s%20bezpe%u010Dnostn%EDm%20materi%E1lem
57871,140,1368568800,135,1,18,1,155,A,Vl.%20n.%20z.%20o%20nakl%E1d%E1n%ED%20s%20bezpe%u010Dnostn%EDm%20materi%E1lem
57872,140,1368568800,49,57,28,22,156,R,Vl.%20n.%20z.%20o%20nakl%E1d%E1n%ED%20s%20bezpe%u010Dnostn%EDm%20materi%E1lem
57873,140,1368568800,109,14,19,14,156,A,Vl.%20n.%20z.%20o%20nakl%E1d%E1n%ED%20s%20bezpe%u010Dnostn%EDm%20materi%E1lem
57874,142,1368568800,110,9,36,4,159,A,Novela%20z.%20o%20pohonn%FDch%20hmot%E1ch
57875,122,1368568800,118,0,41,0,159,A,Novela%20z.%20o%20%u010Cesk%E9%20n%E1rodn%ED%20bance%20-%20EU
57876,122,1368568800,106,12,29,14,161,A,Novela%20z.%20o%20%u010Cesk%E9%20n%E1rodn%ED%20bance%20-%20EU
57877,122,1368568800,109,7,39,5,160,A,Novela%20z.%20o%20%u010Cesk%E9%20n%E1rodn%ED%20bance%20-%20EU
57878,137,1368568800,133,1,24,4,162,A,Vl.n.z.o%20poskyt.st.z%E1ruky%20%u010CR%20na%20zaji%u0161t%u011Bn%ED%20p%u016Fj%u010Dky%20%u010CNB%20pro%20MMF
57879,137,1368568800,109,11,33,8,161,A,Vl.n.z.o%20poskyt.st.z%E1ruky%20%u010CR%20na%20zaji%u0161t%u011Bn%ED%20p%u016Fj%u010Dky%20%u010CNB%20pro%20MMF
57880,149,1368568800,134,0,24,2,160,A,Zpr%E1va%20o%20inflaci%20-%20leden%202013
57881,142,1368568800,130,1,28,0,159,A,Novela%20z.%20o%20pohonn%FDch%20hmot%E1ch
57882,142,1368568800,28,105,23,4,160,R,Novela%20z.%20o%20pohonn%FDch%20hmot%E1ch
57883,142,1368568800,13,102,40,5,160,R,Novela%20z.%20o%20pohonn%FDch%20hmot%E1ch
57884,142,1368568800,27,102,24,7,160,R,Novela%20z.%20o%20pohonn%FDch%20hmot%E1ch
57885,142,1368568800,9,102,42,8,161,R,Novela%20z.%20o%20pohonn%FDch%20hmot%E1ch
57886,142,1368568800,132,1,23,4,160,A,Novela%20z.%20o%20pohonn%FDch%20hmot%E1ch
57887,142,1368568800,126,3,23,7,159,A,Novela%20z.%20o%20pohonn%FDch%20hmot%E1ch
57888,143,1368568800,121,1,29,9,160,A,Novela%20z.%20o%20ov%u011B%u0159ov%E1n%ED%20st%u0159eln%FDch%20zbran%ED
57889,12,1368568800,63,31,58,3,155,R,Novela%20z.%20o%20regulaci%20reklamy%20-%20EU
57890,157,1368568800,101,1,1,0,103,A,Zpr%E1va%20o%20kontrole%20v%FDro%u010Dn%EDch%20finan%u010Dn%EDch%20zpr%E1v%20za%20rok%202012
57891,158,1368568800,95,1,13,0,109,A,Dopln%u011Bn%ED%20v%FDro%u010Dn%EDch%20finan%u010Dn%EDch%20zpr%E1v%20za%20roky%202006%20a%u017E%202011
57892,160,1368568800,97,0,15,0,112,A,N%E1vrh%20%u010Dasov%E9ho%20harmonogramu%20projedn%E1v%E1n%ED%20SZ%DA%20%u010CR%202012
57893,48,1368568800,61,74,1,1,137,R,Vl.n.z.o%20zm%u011Bn%u011B%20da%u0148.z%E1k.%20v%20souv.%20s%20rekodifikac%ED%20soukrom.pr%E1va%20-%20EU
57894,48,1368568800,66,73,0,2,141,R,Vl.n.z.o%20zm%u011Bn%u011B%20da%u0148.z%E1k.%20v%20souv.%20s%20rekodifikac%ED%20soukrom.pr%E1va%20-%20EU
57895,48,1368568800,141,1,1,0,143,A,Vl.n.z.o%20zm%u011Bn%u011B%20da%u0148.z%E1k.%20v%20souv.%20s%20rekodifikac%ED%20soukrom.pr%E1va%20-%20EU
57896,48,1368568800,79,63,1,0,143,A,Vl.n.z.o%20zm%u011Bn%u011B%20da%u0148.z%E1k.%20v%20souv.%20s%20rekodifikac%ED%20soukrom.pr%E1va%20-%20EU
57897,90,1368568800,57,69,1,1,128,R,Vl.n.z.%20o%20dani%20z%20nabyt%ED%20nemovit%FDch%20v%u011Bc%ED
57898,90,1368568800,127,0,2,0,129,A,Vl.n.z.%20o%20dani%20z%20nabyt%ED%20nemovit%FDch%20v%u011Bc%ED
57899,90,1368568800,70,57,2,0,129,A,Vl.n.z.%20o%20dani%20z%20nabyt%ED%20nemovit%FDch%20v%u011Bc%ED
57900,90,1368568800,123,0,6,0,129,A,Vl.n.z.%20o%20dani%20z%20nabyt%ED%20nemovit%FDch%20v%u011Bc%ED
57901,90,1368568800,72,58,1,0,131,A,Vl.n.z.%20o%20dani%20z%20nabyt%ED%20nemovit%FDch%20v%u011Bc%ED
57902,0,1368655200,72,1,11,0,84,A,Po%u0159ad%20sch%u016Fze
57903,0,1368655200,72,1,27,0,100,A,%20
57904,115,1368655200,96,0,26,0,122,A,Prot.o%20obav%E1ch%20irsk%E9ho%20lidu%20t%FDkaj%EDc%EDch%20se%20Lisabonsk%E9%20smlouvy
57905,115,1368655200,100,0,25,0,125,A,Prot.o%20obav%E1ch%20irsk%E9ho%20lidu%20t%FDkaj%EDc%EDch%20se%20Lisabonsk%E9%20smlouvy
57906,154,1368655200,104,0,24,1,129,A,N%E1vrh%20zm%u011Bny%20rozpo%u010Dtu%20SFRB%20na%20rok%202013
57907,114,1368655200,102,0,26,0,128,A,Zm%u011Bna%20P%u0159%EDlohy%20I%20Mezin%E1rodn%ED%20%FAmluvy%20proti%20dopingu%20ve%20sportu
57908,114,1368655200,79,5,37,8,129,A,Zm%u011Bna%20P%u0159%EDlohy%20I%20Mezin%E1rodn%ED%20%FAmluvy%20proti%20dopingu%20ve%20sportu
57909,113,1368655200,98,0,31,0,129,A,Prot.mezi%20%u010CR%20a%20Slov.rep.o%20pr%E1vn%ED%20pomoci%20poskyt.justi%u010D.org%E1ny
57910,104,1368655200,104,0,23,1,128,A,%DAml.%20Organizace%20spojen%FDch%20n%E1rod%u016F%20proti%20korupci
57911,110,1368655200,100,0,29,1,130,A,%DAmluva%20o%20po%u010D%EDta%u010Dov%E9%20kriminalit%u011B
57912,105,1368655200,106,0,24,0,130,A,Sml.mezi%20%u010CR%20a%20Brazil.fed.rep.o%20pomoci%20v%20celn%EDch%20ot%E1zk%E1ch
57913,106,1368655200,111,0,20,0,131,A,Obchodn%ED%20doh.mezi%20st%E1ty%20EU%20a%20Kolumbi%ED%20a%20Peru
57914,107,1368655200,94,1,37,0,132,A,Doh.zakl%E1daj%EDc%ED%20p%u0159idru%u017Een%ED%20mezi%20st%E1ty%20EU%20a%20St%u0159edn%ED%20Amerikou
57915,108,1368655200,99,3,30,0,132,A,Doh.mezi%20%u010CR%20a%20vl.Kajmansk%FDch%20os.%20o%20v%FDm%u011Bn%u011B%20inf.v%20da%u0148.z%E1le%u017E.
57916,109,1368655200,94,0,37,1,132,A,%DAml.o%20vz%E1jemn%E9%20spr%E1vn%ED%20pomoci%20v%20da%u0148.z%E1le%u017Eitostech
57917,111,1368655200,102,0,30,0,132,A,%DAml.%20proti%20nadn%E1rodn%EDmu%20organizovan%E9mu%20zlo%u010Dinu
57918,112,1368655200,103,1,26,0,130,A,Sml.%20mezi%20%u010CR%20a%20Lucem.velkov%E9vodstv%EDm%20o%20zamez.dvoj%EDmu%20zdan%u011Bn%ED
57919,8,1368655200,95,0,35,1,131,A,Novela%20z.%20-%20z%E1kon%EDk%20pr%E1ce
57920,8,1368655200,108,0,18,3,129,A,Novela%20z.%20-%20z%E1kon%EDk%20pr%E1ce
57921,42,1368655200,89,0,40,0,129,A,Vl.n.z.%20o%20prekursorech%20drog%20-%20EU
57922,42,1368655200,88,0,41,0,129,A,Vl.n.z.%20o%20prekursorech%20drog%20-%20EU
57923,43,1368655200,97,0,32,0,129,A,Novela%20z.%20o%20n%E1vykov%FDch%20l%E1tk%E1ch
57924,43,1368655200,95,0,34,0,129,A,Novela%20z.%20o%20n%E1vykov%FDch%20l%E1tk%E1ch
57925,47,1368655200,19,0,109,1,129,R,Novela%20z.%20-%20autorsk%FD%20z%E1kon%20-%20EU
57926,47,1368655200,73,1,55,0,129,A,Novela%20z.%20-%20autorsk%FD%20z%E1kon%20-%20EU
57927,0,1368741600,70,25,26,7,128,A,Po%u0159ad%20sch%u016Fze
57928,0,1368741600,119,4,6,1,130,A,Po%u0159ad%20sch%u016Fze
57929,87,1368741600,11,0,126,0,137,R,Novela%20z.%20o%20sdru%u017Eov%E1n%ED%20v%20politick%FDch%20stran%E1ch%20a%20hnut%EDch
57930,87,1368741600,124,0,16,0,140,A,Novela%20z.%20o%20sdru%u017Eov%E1n%ED%20v%20politick%FDch%20stran%E1ch%20a%20hnut%EDch
57931,87,1368741600,100,16,19,6,141,A,Novela%20z.%20o%20sdru%u017Eov%E1n%ED%20v%20politick%FDch%20stran%E1ch%20a%20hnut%EDch
57932,134,1368741600,0,2,127,0,129,R,Vl.n.z.%20o%20katastru%20nemovitost%ED%20%28katastr%E1ln%ED%20z%E1kon%29
57933,134,1368741600,71,58,9,4,142,R,Vl.n.z.%20o%20katastru%20nemovitost%ED%20%28katastr%E1ln%ED%20z%E1kon%29
57934,134,1368741600,117,5,14,7,143,A,Vl.n.z.%20o%20katastru%20nemovitost%ED%20%28katastr%E1ln%ED%20z%E1kon%29
57935,134,1368741600,72,60,7,3,142,A,Vl.n.z.%20o%20katastru%20nemovitost%ED%20%28katastr%E1ln%ED%20z%E1kon%29
57936,134,1368741600,82,55,6,0,143,A,Vl.n.z.%20o%20katastru%20nemovitost%ED%20%28katastr%E1ln%ED%20z%E1kon%29
57937,134,1368741600,84,41,12,6,143,A,Vl.n.z.%20o%20katastru%20nemovitost%ED%20%28katastr%E1ln%ED%20z%E1kon%29
57938,134,1368741600,138,2,0,3,143,A,Vl.n.z.%20o%20katastru%20nemovitost%ED%20%28katastr%E1ln%ED%20z%E1kon%29
57939,134,1368741600,27,93,6,16,142,R,Vl.n.z.%20o%20katastru%20nemovitost%ED%20%28katastr%E1ln%ED%20z%E1kon%29
57940,134,1368741600,66,29,32,15,142,R,Vl.n.z.%20o%20katastru%20nemovitost%ED%20%28katastr%E1ln%ED%20z%E1kon%29
57941,134,1368741600,63,63,12,4,142,R,Vl.n.z.%20o%20katastru%20nemovitost%ED%20%28katastr%E1ln%ED%20z%E1kon%29
57942,134,1368741600,1,0,142,0,143,R,Vl.n.z.%20o%20katastru%20nemovitost%ED%20%28katastr%E1ln%ED%20z%E1kon%29
57943,134,1368741600,83,50,7,3,143,A,Vl.n.z.%20o%20katastru%20nemovitost%ED%20%28katastr%E1ln%ED%20z%E1kon%29
57944,134,1368741600,63,69,6,5,143,R,Vl.n.z.%20o%20katastru%20nemovitost%ED%20%28katastr%E1ln%ED%20z%E1kon%29
57945,134,1368741600,27,104,7,4,142,R,Vl.n.z.%20o%20katastru%20nemovitost%ED%20%28katastr%E1ln%ED%20z%E1kon%29
57946,134,1368741600,89,29,13,12,143,A,Vl.n.z.%20o%20katastru%20nemovitost%ED%20%28katastr%E1ln%ED%20z%E1kon%29
57947,134,1368741600,75,45,17,6,143,A,Vl.n.z.%20o%20katastru%20nemovitost%ED%20%28katastr%E1ln%ED%20z%E1kon%29
57948,135,1368741600,124,8,3,0,135,A,Vl.n.z.o%20zm%u011Bn%u011B%20z%E1k.v%20souvisl.%20s%20p%u0159ij.%20z.%20o%20katastr.%20nemovit.
57949,135,1368741600,87,36,9,4,136,A,Vl.n.z.o%20zm%u011Bn%u011B%20z%E1k.v%20souvisl.%20s%20p%u0159ij.%20z.%20o%20katastr.%20nemovit.
57950,144,1368741600,13,66,36,24,139,R,Novela%20z.%20o%20platu%20p%u0159edstavitel%u016F%20st%E1tn%ED%20moci
57951,144,1368741600,119,0,8,7,134,A,Novela%20z.%20o%20platu%20p%u0159edstavitel%u016F%20st%E1tn%ED%20moci
57952,80,1368741600,93,1,36,1,131,A,Novela%20z.%20o%20St%E1tn%EDm%20pozemkov%E9m%20%FA%u0159adu
57953,80,1368741600,100,2,29,0,131,A,Novela%20z.%20o%20St%E1tn%EDm%20pozemkov%E9m%20%FA%u0159adu
57954,81,1368741600,101,0,29,0,130,A,Novela%20z.%20o%20dan%EDch%20z%20p%u0159%EDjm%u016F
57955,81,1368741600,100,2,25,4,131,A,Novela%20z.%20o%20dan%EDch%20z%20p%u0159%EDjm%u016F
57956,81,1368741600,95,3,30,2,130,A,Novela%20z.%20o%20dan%EDch%20z%20p%u0159%EDjm%u016F
57957,145,1368741600,103,0,24,0,127,A,N%E1vrh%20na%20zm%u011Bny%20ve%20slo%u017Een%ED%20org%E1n%u016F%20Poslaneck%E9%20sn%u011Bmovny
57958,145,1368741600,102,0,25,0,127,A,N%E1vrh%20na%20zm%u011Bny%20ve%20slo%u017Een%ED%20org%E1n%u016F%20Poslaneck%E9%20sn%u011Bmovny
57959,85,1368741600,97,2,26,0,125,A,Vl.n.z.%20o%20p%u0159evodu%20vlastnick%E9ho%20pr%E1va
57960,88,1368741600,105,1,22,0,128,A,Novela%20z.%20o%20matrik%E1ch%2C%20jm%E9nu%20a%20p%u0159%EDjmen%ED
57961,88,1368741600,73,24,27,4,128,A,Novela%20z.%20o%20matrik%E1ch%2C%20jm%E9nu%20a%20p%u0159%EDjmen%ED
57962,0,1368741600,62,23,34,4,123,A,%20
57963,0,1370901600,127,0,24,0,151,A,%20
57964,0,1370901600,171,2,10,3,186,A,Po%u0159ad%20sch%u016Fze
57965,0,1370901600,84,71,16,15,186,R,Po%u0159ad%20sch%u016Fze
57966,0,1370901600,91,80,10,6,187,R,Po%u0159ad%20sch%u016Fze
57967,0,1370901600,85,87,11,4,187,R,Po%u0159ad%20sch%u016Fze
57968,0,1370901600,149,2,30,6,187,A,Po%u0159ad%20sch%u016Fze
57969,0,1370901600,90,72,13,12,187,R,Po%u0159ad%20sch%u016Fze
57970,0,1370901600,174,2,6,6,188,A,Po%u0159ad%20sch%u016Fze
57971,0,1370901600,86,86,11,4,187,R,Po%u0159ad%20sch%u016Fze
57972,0,1370901600,173,4,6,4,187,A,Po%u0159ad%20sch%u016Fze
57973,0,1370901600,98,67,13,9,187,A,Po%u0159ad%20sch%u016Fze
57974,0,1370901600,178,2,4,3,187,A,Po%u0159ad%20sch%u016Fze
57975,0,1370901600,102,21,36,28,187,A,Po%u0159ad%20sch%u016Fze
57976,0,1370901600,174,3,8,2,187,A,Po%u0159ad%20sch%u016Fze
57977,0,1370901600,171,7,8,1,187,A,Po%u0159ad%20sch%u016Fze
57978,0,1370901600,84,40,37,26,187,R,Po%u0159ad%20sch%u016Fze
57979,0,1370901600,101,28,33,26,188,A,Po%u0159ad%20sch%u016Fze
57980,0,1370901600,105,29,37,17,188,A,Po%u0159ad%20sch%u016Fze
57981,0,1370901600,167,6,11,4,188,A,Po%u0159ad%20sch%u016Fze
57982,0,1370901600,91,64,16,17,188,R,Po%u0159ad%20sch%u016Fze
57983,0,1370901600,149,7,30,2,188,A,Po%u0159ad%20sch%u016Fze
57984,0,1370901600,93,86,7,2,188,R,Po%u0159ad%20sch%u016Fze
57985,0,1370901600,142,14,30,2,188,A,Po%u0159ad%20sch%u016Fze
57986,0,1370901600,97,84,6,1,188,A,Po%u0159ad%20sch%u016Fze
57987,0,1370901600,172,3,13,0,188,A,Po%u0159ad%20sch%u016Fze
57988,0,1370901600,97,89,2,1,189,A,Po%u0159ad%20sch%u016Fze
57989,0,1370901600,90,86,9,4,189,R,Po%u0159ad%20sch%u016Fze
57990,0,1370901600,41,103,18,27,189,R,Po%u0159ad%20sch%u016Fze
57991,0,1370901600,84,92,12,1,189,R,Po%u0159ad%20sch%u016Fze
57992,0,1370901600,86,93,6,4,189,R,Po%u0159ad%20sch%u016Fze
57993,0,1370901600,120,29,27,11,187,A,Po%u0159ad%20sch%u016Fze
57994,0,1370901600,112,26,39,11,188,A,Po%u0159ad%20sch%u016Fze
57995,0,1370901600,97,42,30,19,188,A,Po%u0159ad%20sch%u016Fze
57996,1,1370901600,89,70,4,2,165,A,N%E1vrh%20na%20zkr%E1cen%ED%20lh%u016Fty%20ST%20990%20ve%20v%FDborech%20PS
57997,91,1370901600,126,2,47,0,175,A,Novela%20z.%20o%20evidenci%20obyvatel
57998,91,1370901600,63,46,55,12,176,R,Novela%20z.%20o%20evidenci%20obyvatel
57999,108,1370901600,107,7,62,2,178,A,Vl.n.z.o%20zm%u011Bn%u011B%20z%E1k.v%20p%u016Fsob.%20MV%20v%20souv.%20s%20p%u0159ij.%20kontrol.%20%u0159%E1du
58000,108,1370901600,79,25,68,6,178,R,Vl.n.z.o%20zm%u011Bn%u011B%20z%E1k.v%20p%u016Fsob.%20MV%20v%20souv.%20s%20p%u0159ij.%20kontrol.%20%u0159%E1du
58001,0,1370901600,117,1,57,3,178,A,%20
58002,3,1370901600,84,47,29,19,179,R,Novela%20z.%20o%20insolven%u010Dn%EDch%20spr%E1vc%EDch
58003,3,1370901600,117,14,26,23,180,A,Novela%20z.%20o%20insolven%u010Dn%EDch%20spr%E1vc%EDch
58004,4,1370901600,55,83,25,4,167,R,Novela%20z.%20-%20obchodn%ED%20z%E1kon%EDk%20-%20EU
58005,4,1370901600,123,12,10,27,172,A,Novela%20z.%20-%20obchodn%ED%20z%E1kon%EDk%20-%20EU
58006,5,1370901600,6,94,36,39,175,R,Vl.n.z.%20o%20st%E1tn%EDm%20ob%u010Danstv%ED%20%u010Cesk%E9%20republiky
58007,5,1370901600,120,13,21,24,178,A,Vl.n.z.%20o%20st%E1tn%EDm%20ob%u010Danstv%ED%20%u010Cesk%E9%20republiky
58008,7,1370901600,71,50,26,21,168,R,Novela%20z.%20o%20stavebn%EDm%20spo%u0159en%ED%20-%20EU
58009,0,1370988000,116,1,4,1,122,A,Po%u0159ad%20sch%u016Fze
58010,0,1370988000,88,18,9,9,124,A,Po%u0159ad%20sch%u016Fze
58011,50,1370988000,108,0,68,1,177,A,Vl.n.z.%20o%20st%E1tn%EDm%20zastupitelstv%ED%20-%20EU
58012,51,1370988000,122,0,54,1,177,A,Vl.n.z.%20o%20st%E1tn%EDm%20zastupitelstv%ED%20-%20souvisej%EDc%ED%20-%20EU
58013,47,1370988000,114,0,59,0,173,A,Novela%20z.%20o%20n%u011Bkter.podm%EDnk%E1ch%20podnik%E1n%ED%20v%20oblasti%20cest.ruchu%20-%20EU
58014,0,1371074400,68,37,11,9,125,A,%20
58015,0,1371160800,153,4,1,0,158,A,%20
58016,0,1371506400,17,89,55,12,173,R,Po%u0159ad%20sch%u016Fze
58017,0,1371506400,101,25,35,16,177,A,Po%u0159ad%20sch%u016Fze
58018,0,1371506400,140,5,28,4,177,A,Po%u0159ad%20sch%u016Fze
58019,0,1371506400,154,7,11,4,176,A,Po%u0159ad%20sch%u016Fze
58020,0,1371506400,132,10,29,6,177,A,Po%u0159ad%20sch%u016Fze
58021,0,1371506400,102,24,36,15,177,A,Po%u0159ad%20sch%u016Fze
58022,0,1371506400,145,4,25,3,177,A,Po%u0159ad%20sch%u016Fze
58023,0,1371506400,154,4,17,1,176,A,Po%u0159ad%20sch%u016Fze
58024,168,1371506400,69,0,105,0,174,R,Ro%u010Dn%ED%20zpr%E1va%20o%20v%FDsledku%20hospoda%u0159en%ED%20%u010CNB%20za%20rok%202012
58025,168,1371506400,114,0,7,0,121,A,Ro%u010Dn%ED%20zpr%E1va%20o%20v%FDsledku%20hospoda%u0159en%ED%20%u010CNB%20za%20rok%202012
58026,168,1371506400,122,6,19,2,149,A,Ro%u010Dn%ED%20zpr%E1va%20o%20v%FDsledku%20hospoda%u0159en%ED%20%u010CNB%20za%20rok%202012
58027,10,1371506400,110,6,37,4,157,A,Vl.n.z.%20o%20Vojensk%E9%20policii%20-%20EU
58028,37,1371506400,108,1,55,2,166,A,Novela%20z.%20o%20ochran%u011B%20zem%u011Bd%u011Blsk%E9ho%20p%u016Fdn%EDho%20fondu
58029,190,1371506400,115,3,48,2,168,A,Vl.n.z.%20o%20prekursorech%20drog%20-%20EU
58030,191,1371506400,106,6,51,4,167,A,Novela%20z.%20o%20n%E1vykov%FDch%20l%E1tk%E1ch
58031,111,1371506400,97,4,62,6,169,A,Prot.proti%20pa%u0161ov%E1n%ED%20p%u0159ist%u011Bhovalc%u016F%20po%20zemi%2C%20po%20mo%u0159i%20a%20letecky
58032,112,1371506400,100,0,63,2,165,A,Prot.%20proti%20nedovolen%E9%20v%FDrob%u011B%20st%u0159eln%FDch%20zbran%ED
58033,113,1371506400,112,0,56,0,168,A,Op%u010Dn%ED%20protokol%20k%20%DAmluv%u011B%20o%20pr%E1vech%20d%EDt%u011Bte
58034,114,1371506400,111,1,55,1,168,A,Zm%u011Bna%20P%u0159%EDlohy%20I%20Mezin%E1rodn%ED%20%FAmluvy%20proti%20dopingu%20ve%20sportu
58035,116,1371506400,107,0,60,1,168,A,Doh.%20mezi%20%u010CR%20a%20%u010C%EDn.%20lid.%20repub.%20Hongkong%20o%20p%u0159ed%E1v%E1n%ED%20osob
58036,116,1371506400,115,1,52,0,168,A,Doh.%20mezi%20%u010CR%20a%20%u010C%EDn.%20lid.%20repub.%20Hongkong%20o%20p%u0159ed%E1v%E1n%ED%20osob
58037,117,1371506400,119,0,50,0,169,A,Doh.%20mezi%20%u010CR%20a%20%u010C%EDn.%20lid.%20rep.%20o%20vz%E1j.%20pomoci%20v%20trest.%20v%u011Bcech
58038,118,1371506400,117,0,52,0,169,A,Doh.%20mezi%20%u010CR%20a%20%u010C%EDn.%20lid.%20rep.%20o%20p%u0159ed%E1v%E1n%ED%20odsouzen%FDch%20osob
58039,119,1371506400,118,0,49,1,168,A,Prot.%20o%20p%u0159edch%E1zen%ED%2C%20potla%u010D.%20a%20trest%E1n%ED%20obchodov%E1n%ED%20s%20lidmi
58040,0,1371592800,133,1,6,0,140,A,Po%u0159ad%20sch%u016Fze
58041,0,1371592800,48,30,33,32,143,R,Po%u0159ad%20sch%u016Fze
58042,0,1371592800,112,1,27,3,143,A,Po%u0159ad%20sch%u016Fze
58043,0,1371592800,45,70,15,14,144,R,Po%u0159ad%20sch%u016Fze
58044,115,1371592800,125,0,29,0,154,A,Sml.%20mezi%20%u010CR%20a%20SRN%20o%20p%u0159eshrani%u010Dn%ED%20spolupr%E1ci
58045,115,1371592800,120,3,32,1,156,A,Sml.%20mezi%20%u010CR%20a%20SRN%20o%20p%u0159eshrani%u010Dn%ED%20spolupr%E1ci
58046,160,1371592800,97,1,62,1,161,A,Zpr.o%20%u010Dinnosti%20kontrol.%20rady%20Grantov%E9%20agen.%u010CR%20r.%202011%20-%202012
58047,161,1371592800,106,1,54,1,162,A,Stanoven%ED%20v%FD%u0161e%20odm%u011Bny%20%u010Dlen%u016Fm%20Kontroln%ED%20rady%20Grantov%E9%20agentury%20%u010CR
58048,162,1371592800,104,1,57,0,162,A,Zpr.%20o%20%u010Dinnosti%20kontrol.%20rady%20GA%20%u010CR%20%u0159%EDjen%202012%20-%20b%u0159ezen%202013
58049,166,1371592800,112,1,50,0,163,A,V%FDro%u010Dn%ED%20zpr%E1va%20o%20%u010Dinnosti%20Kontroln%ED%20rady%20TA%20%u010CR%20za%20rok%202012
58050,167,1371592800,112,0,50,0,162,A,Stanoven%ED%20v%FD%u0161e%20odm%u011Bny%20%u010Dlen%u016Fm%20Kontroln%ED%20rady%20Technologick%E9%20agentury%20%u010CR
58051,164,1371592800,72,34,6,2,114,A,Zpr%E1va%20o%20%u010Dinnosti%20RRTV%20za%20rok%202012
58052,0,1372111200,89,70,6,1,166,A,%20
58053,0,1374012000,162,0,10,0,172,A,%20
58054,0,1374012000,152,3,11,15,181,A,Po%u0159ad%20sch%u016Fze
58055,1,1374012000,89,90,7,3,189,R,N%E1vrh%20usnesen%ED%20k%20usnesen%ED%20o%20rozpu%u0161t%u011Bn%ED%20Poslaneck%E9%20sn%u011Bmovny
58056,1,1374012000,162,12,8,5,187,A,N%E1vrh%20usnesen%ED%20k%20usnesen%ED%20o%20rozpu%u0161t%u011Bn%ED%20Poslaneck%E9%20sn%u011Bmovny
58057,1,1374012000,94,89,3,2,188,R,N%E1vrh%20usnesen%ED%20k%20usnesen%ED%20o%20rozpu%u0161t%u011Bn%ED%20Poslaneck%E9%20sn%u011Bmovny
58058,1,1374012000,96,92,0,0,188,R,N%E1vrh%20usnesen%ED%20k%20usnesen%ED%20o%20rozpu%u0161t%u011Bn%ED%20Poslaneck%E9%20sn%u011Bmovny
58059,0,1374012000,134,0,8,0,142,A,%20
58060,0,1374012000,142,1,12,0,155,A,%20
58061,0,1374012000,135,2,19,1,157,A,%20
58062,1,1374012000,72,81,8,1,162,R,Novela%20z.%20o%20m%EDstn%EDch%20poplatc%EDch
58063,1,1374012000,145,11,5,1,162,A,Novela%20z.%20o%20m%EDstn%EDch%20poplatc%EDch
58064,1,1374012000,113,1,48,1,163,A,Novela%20z.%20o%20m%EDstn%EDch%20poplatc%EDch
58065,1,1374012000,155,0,6,2,163,A,Novela%20z.%20o%20m%EDstn%EDch%20poplatc%EDch
58066,1,1374012000,120,38,5,1,164,A,Novela%20z.%20o%20m%EDstn%EDch%20poplatc%EDch
58067,1,1374012000,154,2,5,4,165,A,Novela%20z.%20o%20m%EDstn%EDch%20poplatc%EDch
58068,1,1374012000,142,13,7,3,165,A,Novela%20z.%20o%20m%EDstn%EDch%20poplatc%EDch
58069,1,1374012000,120,34,9,2,165,A,Novela%20z.%20o%20m%EDstn%EDch%20poplatc%EDch
58070,1,1374012000,44,84,12,25,165,R,Novela%20z.%20o%20m%EDstn%EDch%20poplatc%EDch
58071,1,1374012000,84,19,38,24,165,A,Novela%20z.%20o%20m%EDstn%EDch%20poplatc%EDch
58072,1,1374012000,49,78,29,7,163,R,Novela%20z.%20o%20m%EDstn%EDch%20poplatc%EDch
58073,1,1374012000,13,89,40,22,164,R,Novela%20z.%20o%20m%EDstn%EDch%20poplatc%EDch
58074,1,1374012000,75,76,7,6,164,R,Novela%20z.%20o%20m%EDstn%EDch%20poplatc%EDch
58075,1,1374012000,110,44,5,5,164,A,Novela%20z.%20o%20m%EDstn%EDch%20poplatc%EDch
58076,2,1374012000,138,0,22,2,162,A,Vl%E1dn%ED%20n%E1vrh%20z%E1kona%20o%20sm%u011Bn%E1rensk%E9%20%u010Dinnosti%20-%20EU
58077,2,1374012000,86,5,50,21,162,A,Vl%E1dn%ED%20n%E1vrh%20z%E1kona%20o%20sm%u011Bn%E1rensk%E9%20%u010Dinnosti%20-%20EU
58078,2,1374012000,113,7,19,23,162,A,Vl%E1dn%ED%20n%E1vrh%20z%E1kona%20o%20sm%u011Bn%E1rensk%E9%20%u010Dinnosti%20-%20EU
58079,3,1374012000,143,0,17,2,162,A,Novela%20z.%20o%20sm%u011Bn%E1rensk%E9%20%u010Dinnosti%20-%20souvisej%EDc%ED
58080,3,1374012000,116,4,22,20,162,A,Novela%20z.%20o%20sm%u011Bn%E1rensk%E9%20%u010Dinnosti%20-%20souvisej%EDc%ED
58081,3,1374012000,144,1,17,0,162,A,Novela%20z.%20o%20sm%u011Bn%E1rensk%E9%20%u010Dinnosti%20-%20souvisej%EDc%ED
58082,3,1374012000,111,7,22,21,161,A,Novela%20z.%20o%20sm%u011Bn%E1rensk%E9%20%u010Dinnosti%20-%20souvisej%EDc%ED
58083,4,1374012000,143,0,19,0,162,A,Novela%20z.%20o%20d%u016Fchodov%E9m%20poji%u0161t%u011Bn%ED
58084,4,1374012000,143,1,18,0,162,A,Novela%20z.%20o%20d%u016Fchodov%E9m%20poji%u0161t%u011Bn%ED
58085,5,1374012000,25,90,31,15,161,R,Novela%20z.%20o%20ochran%u011B%20zem%u011Bd%u011Blsk%E9ho%20p%u016Fdn%EDho%20fondu
58086,5,1374012000,138,1,20,2,161,A,Novela%20z.%20o%20ochran%u011B%20zem%u011Bd%u011Blsk%E9ho%20p%u016Fdn%EDho%20fondu
58087,5,1374012000,133,6,20,2,161,A,Novela%20z.%20o%20ochran%u011B%20zem%u011Bd%u011Blsk%E9ho%20p%u016Fdn%EDho%20fondu
58088,5,1374012000,90,4,46,21,161,A,Novela%20z.%20o%20ochran%u011B%20zem%u011Bd%u011Blsk%E9ho%20p%u016Fdn%EDho%20fondu
58089,5,1374012000,96,7,45,14,162,A,Novela%20z.%20o%20ochran%u011B%20zem%u011Bd%u011Blsk%E9ho%20p%u016Fdn%EDho%20fondu
58090,5,1374012000,101,30,26,5,162,A,Novela%20z.%20o%20ochran%u011B%20zem%u011Bd%u011Blsk%E9ho%20p%u016Fdn%EDho%20fondu
58091,6,1374012000,132,0,26,1,159,A,Vl.n.z.%20o%20Vojensk%E9%20policii%20-%20EU
58092,6,1374012000,8,96,50,6,160,R,Vl.n.z.%20o%20Vojensk%E9%20policii%20-%20EU
58093,6,1374012000,135,0,25,0,160,A,Vl.n.z.%20o%20Vojensk%E9%20policii%20-%20EU
58094,6,1374012000,138,0,22,0,160,A,Vl.n.z.%20o%20Vojensk%E9%20policii%20-%20EU
58095,7,1374012000,140,0,20,0,160,A,Novela%20z.%20o%20v%FDkonu%20vazby
58096,7,1374012000,141,0,19,0,160,A,Novela%20z.%20o%20v%FDkonu%20vazby
58097,7,1374012000,44,76,39,1,160,R,Novela%20z.%20o%20v%FDkonu%20vazby
58098,7,1374012000,91,4,44,21,160,A,Novela%20z.%20o%20v%FDkonu%20vazby
58099,8,1374012000,5,117,29,7,158,R,Novela%20z.%20o%20vodovodech%20a%20kanalizac%EDch%20-%20EU
58100,8,1374012000,127,0,28,4,159,A,Novela%20z.%20o%20vodovodech%20a%20kanalizac%EDch%20-%20EU
58101,8,1374012000,66,56,29,8,159,R,Novela%20z.%20o%20vodovodech%20a%20kanalizac%EDch%20-%20EU
58102,8,1374012000,127,0,29,3,159,A,Novela%20z.%20o%20vodovodech%20a%20kanalizac%EDch%20-%20EU
58103,8,1374012000,122,1,33,3,159,A,Novela%20z.%20o%20vodovodech%20a%20kanalizac%EDch%20-%20EU
58104,8,1374012000,62,33,46,18,159,R,Novela%20z.%20o%20vodovodech%20a%20kanalizac%EDch%20-%20EU
58105,8,1374012000,37,66,37,20,160,R,Novela%20z.%20o%20vodovodech%20a%20kanalizac%EDch%20-%20EU
58106,8,1374012000,116,0,31,13,160,A,Novela%20z.%20o%20vodovodech%20a%20kanalizac%EDch%20-%20EU
58107,8,1374012000,29,66,50,15,160,R,Novela%20z.%20o%20vodovodech%20a%20kanalizac%EDch%20-%20EU
58108,8,1374012000,62,68,26,4,160,R,Novela%20z.%20o%20vodovodech%20a%20kanalizac%EDch%20-%20EU
58109,8,1374012000,36,25,97,2,160,R,Novela%20z.%20o%20vodovodech%20a%20kanalizac%EDch%20-%20EU
58110,8,1374012000,55,72,27,6,160,R,Novela%20z.%20o%20vodovodech%20a%20kanalizac%EDch%20-%20EU
58111,8,1374012000,24,67,52,16,159,R,Novela%20z.%20o%20vodovodech%20a%20kanalizac%EDch%20-%20EU
58112,8,1374012000,126,10,21,0,157,A,Novela%20z.%20o%20vodovodech%20a%20kanalizac%EDch%20-%20EU
58113,8,1374012000,78,5,48,25,156,R,Novela%20z.%20o%20vodovodech%20a%20kanalizac%EDch%20-%20EU
58114,8,1374012000,124,1,9,1,135,A,Novela%20z.%20o%20vodovodech%20a%20kanalizac%EDch%20-%20EU
58115,8,1374012000,79,8,30,18,135,A,Novela%20z.%20o%20vodovodech%20a%20kanalizac%EDch%20-%20EU
58116,9,1374012000,131,0,9,0,140,A,Novela%20z.%20o%20kontrole%20obchodu%20s%20v%FDrobky%20-%20EU
58117,9,1374012000,133,0,6,0,139,A,Novela%20z.%20o%20kontrole%20obchodu%20s%20v%FDrobky%20-%20EU
58118,10,1374012000,106,3,17,13,139,A,Novela%20z.o%20%DAst%u0159ed.%20kontroln%EDm%20a%20zku%u0161ebn%EDm%20%FAstavu%20zem%u011Bd%u011Blsk%E9m%20-%20EU
58119,11,1374012000,126,0,13,0,139,A,Novela%20z.%20o%20St%E1tn%EDm%20pozemkov%E9m%20%FA%u0159adu
58120,11,1374012000,101,4,17,19,141,A,Novela%20z.%20o%20St%E1tn%EDm%20pozemkov%E9m%20%FA%u0159adu
58121,11,1374012000,105,4,14,19,142,A,Novela%20z.%20o%20St%E1tn%EDm%20pozemkov%E9m%20%FA%u0159adu
58122,12,1374012000,130,0,12,0,142,A,Vl.n.z.%20o%20prekursorech%20drog%20-%20EU
58123,13,1374012000,126,0,15,0,141,A,Novela%20z.%20o%20n%E1vykov%FDch%20l%E1tk%E1ch
58124,13,1374012000,127,0,14,0,141,A,Novela%20z.%20o%20n%E1vykov%FDch%20l%E1tk%E1ch
58125,13,1374012000,129,0,12,0,141,A,Novela%20z.%20o%20n%E1vykov%FDch%20l%E1tk%E1ch
58126,14,1374012000,99,24,14,5,142,A,Novela%20z.%20o%20st%E1tn%ED%20soci%E1ln%ED%20podpo%u0159e
58127,14,1374012000,95,21,23,3,142,A,Novela%20z.%20o%20st%E1tn%ED%20soci%E1ln%ED%20podpo%u0159e
58128,14,1374012000,96,23,21,2,142,A,Novela%20z.%20o%20st%E1tn%ED%20soci%E1ln%ED%20podpo%u0159e
58129,14,1374012000,93,25,18,4,140,A,Novela%20z.%20o%20st%E1tn%ED%20soci%E1ln%ED%20podpo%u0159e
58130,0,1375826400,187,2,2,1,192,A,Po%u0159ad%20sch%u016Fze
58131,0,1375826400,190,0,1,0,191,A,""
58132,0,1375826400,7,180,0,0,187,A,""
58133,0,1375826400,7,184,1,0,192,A,""
58134,0,1375826400,101,90,2,0,193,A,""
58135,0,1375826400,184,0,12,0,196,A,""
58136,0,1375826400,111,53,21,0,185,A,""
58137,0,1375826400,0,0,0,0,0,A,""
58138,0,1375826400,87,99,0,0,192,R,""
58139,1,1375826400,174,4,17,1,196,A,%u017D%E1dost%20vl%E1dy%20%u010Cesk%E9%20republiky%20o%20vysloven%ED%20d%u016Fv%u011Bry
58140,1,1375826400,93,100,0,0,193,R,%u017D%E1dost%20vl%E1dy%20%u010Cesk%E9%20republiky%20o%20vysloven%ED%20d%u016Fv%u011Bry
58141,0,1375912800,135,1,16,1,153,A,Po%u0159ad%20sch%u016Fze
58142,0,1375912800,141,0,13,0,154,A,Po%u0159ad%20sch%u016Fze
58143,24,1375912800,144,0,14,0,158,A,N%E1vrhy%20PS%20na%20prop%u016Fj%u010Den%ED%20nebo%20ud%u011Blen%ED%20st%E1tn%EDch%20vyznamen%E1n%ED
58144,3,1375912800,77,45,18,11,151,A,Vl.n.z.%20o%20katastru%20nemovitost%ED%20%28katastr%E1ln%ED%20z%E1kon%29
58145,23,1375912800,145,0,7,0,152,A,Vl.n.z.o%20zm%u011Bn%u011B%20da%u0148.z%E1k.%20v%20souv.%20s%20rekodifikac%ED%20soukrom.pr%E1va%20-%20EU
58146,23,1375912800,108,32,10,2,152,A,Vl.n.z.o%20zm%u011Bn%u011B%20da%u0148.z%E1k.%20v%20souv.%20s%20rekodifikac%ED%20soukrom.pr%E1va%20-%20EU
58147,23,1375912800,110,32,9,1,152,A,Vl.n.z.o%20zm%u011Bn%u011B%20da%u0148.z%E1k.%20v%20souv.%20s%20rekodifikac%ED%20soukrom.pr%E1va%20-%20EU
58148,23,1375912800,46,83,13,10,152,R,Vl.n.z.o%20zm%u011Bn%u011B%20da%u0148.z%E1k.%20v%20souv.%20s%20rekodifikac%ED%20soukrom.pr%E1va%20-%20EU
58149,23,1375912800,112,15,14,11,152,A,Vl.n.z.o%20zm%u011Bn%u011B%20da%u0148.z%E1k.%20v%20souv.%20s%20rekodifikac%ED%20soukrom.pr%E1va%20-%20EU
58150,23,1375912800,138,7,6,1,152,A,Vl.n.z.o%20zm%u011Bn%u011B%20da%u0148.z%E1k.%20v%20souv.%20s%20rekodifikac%ED%20soukrom.pr%E1va%20-%20EU
58151,23,1375912800,136,5,9,2,152,A,Vl.n.z.o%20zm%u011Bn%u011B%20da%u0148.z%E1k.%20v%20souv.%20s%20rekodifikac%ED%20soukrom.pr%E1va%20-%20EU
58152,23,1375912800,110,16,15,11,152,A,Vl.n.z.o%20zm%u011Bn%u011B%20da%u0148.z%E1k.%20v%20souv.%20s%20rekodifikac%ED%20soukrom.pr%E1va%20-%20EU
58153,23,1375912800,65,78,9,0,152,R,Vl.n.z.o%20zm%u011Bn%u011B%20da%u0148.z%E1k.%20v%20souv.%20s%20rekodifikac%ED%20soukrom.pr%E1va%20-%20EU
58154,23,1375912800,62,78,11,1,152,R,Vl.n.z.o%20zm%u011Bn%u011B%20da%u0148.z%E1k.%20v%20souv.%20s%20rekodifikac%ED%20soukrom.pr%E1va%20-%20EU
58155,23,1375912800,42,70,31,9,152,R,Vl.n.z.o%20zm%u011Bn%u011B%20da%u0148.z%E1k.%20v%20souv.%20s%20rekodifikac%ED%20soukrom.pr%E1va%20-%20EU
58156,23,1375912800,36,82,29,5,152,R,Vl.n.z.o%20zm%u011Bn%u011B%20da%u0148.z%E1k.%20v%20souv.%20s%20rekodifikac%ED%20soukrom.pr%E1va%20-%20EU
58157,23,1375912800,9,88,39,16,152,R,Vl.n.z.o%20zm%u011Bn%u011B%20da%u0148.z%E1k.%20v%20souv.%20s%20rekodifikac%ED%20soukrom.pr%E1va%20-%20EU
58158,23,1375912800,7,90,39,16,152,R,Vl.n.z.o%20zm%u011Bn%u011B%20da%u0148.z%E1k.%20v%20souv.%20s%20rekodifikac%ED%20soukrom.pr%E1va%20-%20EU
58159,23,1375912800,60,78,12,2,152,R,Vl.n.z.o%20zm%u011Bn%u011B%20da%u0148.z%E1k.%20v%20souv.%20s%20rekodifikac%ED%20soukrom.pr%E1va%20-%20EU
58160,23,1375912800,141,3,8,0,152,A,Vl.n.z.o%20zm%u011Bn%u011B%20da%u0148.z%E1k.%20v%20souv.%20s%20rekodifikac%ED%20soukrom.pr%E1va%20-%20EU
58161,23,1375912800,67,78,1,1,147,R,Vl.n.z.o%20zm%u011Bn%u011B%20da%u0148.z%E1k.%20v%20souv.%20s%20rekodifikac%ED%20soukrom.pr%E1va%20-%20EU
58162,23,1375912800,68,80,2,0,150,R,Vl.n.z.o%20zm%u011Bn%u011B%20da%u0148.z%E1k.%20v%20souv.%20s%20rekodifikac%ED%20soukrom.pr%E1va%20-%20EU
58163,23,1375912800,84,35,26,5,150,A,Vl.n.z.o%20zm%u011Bn%u011B%20da%u0148.z%E1k.%20v%20souv.%20s%20rekodifikac%ED%20soukrom.pr%E1va%20-%20EU
58164,23,1375912800,108,34,9,0,151,A,Vl.n.z.o%20zm%u011Bn%u011B%20da%u0148.z%E1k.%20v%20souv.%20s%20rekodifikac%ED%20soukrom.pr%E1va%20-%20EU
58165,23,1375912800,143,1,7,0,151,A,Vl.n.z.o%20zm%u011Bn%u011B%20da%u0148.z%E1k.%20v%20souv.%20s%20rekodifikac%ED%20soukrom.pr%E1va%20-%20EU
58166,23,1375912800,149,1,1,0,151,A,Vl.n.z.o%20zm%u011Bn%u011B%20da%u0148.z%E1k.%20v%20souv.%20s%20rekodifikac%ED%20soukrom.pr%E1va%20-%20EU
58167,23,1375912800,80,68,1,2,151,A,Vl.n.z.o%20zm%u011Bn%u011B%20da%u0148.z%E1k.%20v%20souv.%20s%20rekodifikac%ED%20soukrom.pr%E1va%20-%20EU
58168,7,1375912800,100,12,20,15,147,A,Vl.n.z.%20o%20dani%20z%20nabyt%ED%20nemovit%FDch%20v%u011Bc%ED
58169,7,1375912800,134,0,12,1,147,A,Vl.n.z.%20o%20dani%20z%20nabyt%ED%20nemovit%FDch%20v%u011Bc%ED
58170,7,1375912800,68,49,16,12,145,R,Vl.n.z.%20o%20dani%20z%20nabyt%ED%20nemovit%FDch%20v%u011Bc%ED
58171,0,1375912800,19,1,124,0,144,R,%20
58172,7,1375912800,99,11,23,4,137,A,Vl.n.z.%20o%20dani%20z%20nabyt%ED%20nemovit%FDch%20v%u011Bc%ED
58173,7,1375912800,73,33,5,3,114,A,Vl.n.z.%20o%20dani%20z%20nabyt%ED%20nemovit%FDch%20v%u011Bc%ED
58174,8,1375912800,88,8,30,8,134,A,Novela%20z.%20-%20tiskov%FD%20z%E1kon
58175,8,1375912800,61,33,29,10,133,R,Novela%20z.%20-%20tiskov%FD%20z%E1kon
58176,8,1375912800,69,26,27,11,133,A,Novela%20z.%20-%20tiskov%FD%20z%E1kon
58177,9,1375912800,59,66,3,0,128,R,N.z.%2C%20kter%FDm%20se%20zru%u0161uje%20karta%20soci%E1ln%EDch%20syst%E9m%u016F
58178,9,1375912800,3,1,125,0,129,R,N.z.%2C%20kter%FDm%20se%20zru%u0161uje%20karta%20soci%E1ln%EDch%20syst%E9m%u016F
58179,9,1375912800,107,12,3,7,129,A,N.z.%2C%20kter%FDm%20se%20zru%u0161uje%20karta%20soci%E1ln%EDch%20syst%E9m%u016F
58180,9,1375912800,84,39,2,2,127,A,N.z.%2C%20kter%FDm%20se%20zru%u0161uje%20karta%20soci%E1ln%EDch%20syst%E9m%u016F
58181,10,1375912800,111,0,19,0,130,A,Novela%20z.%20-%20insolven%u010Dn%ED%20z%E1kon
58182,10,1375912800,94,0,33,3,130,A,Novela%20z.%20-%20insolven%u010Dn%ED%20z%E1kon
58183,11,1375912800,0,0,129,0,129,R,Novela%20z.%20v%20souv.%20s%20p%u0159ijet%EDm%20rekodifikace%20soukrom%E9ho%20pr%E1va%20-%20EU
58184,11,1375912800,54,66,10,0,130,R,Novela%20z.%20v%20souv.%20s%20p%u0159ijet%EDm%20rekodifikace%20soukrom%E9ho%20pr%E1va%20-%20EU
58185,11,1375912800,67,15,29,19,130,A,Novela%20z.%20v%20souv.%20s%20p%u0159ijet%EDm%20rekodifikace%20soukrom%E9ho%20pr%E1va%20-%20EU
58186,11,1375912800,68,14,32,16,130,A,Novela%20z.%20v%20souv.%20s%20p%u0159ijet%EDm%20rekodifikace%20soukrom%E9ho%20pr%E1va%20-%20EU
58187,11,1375912800,69,14,33,14,130,A,Novela%20z.%20v%20souv.%20s%20p%u0159ijet%EDm%20rekodifikace%20soukrom%E9ho%20pr%E1va%20-%20EU
58188,11,1375912800,89,27,10,4,130,A,Novela%20z.%20v%20souv.%20s%20p%u0159ijet%EDm%20rekodifikace%20soukrom%E9ho%20pr%E1va%20-%20EU
58189,11,1375912800,57,64,9,0,130,R,Novela%20z.%20v%20souv.%20s%20p%u0159ijet%EDm%20rekodifikace%20soukrom%E9ho%20pr%E1va%20-%20EU
58190,11,1375912800,3,86,30,11,130,R,Novela%20z.%20v%20souv.%20s%20p%u0159ijet%EDm%20rekodifikace%20soukrom%E9ho%20pr%E1va%20-%20EU
58191,11,1375912800,1,83,31,15,130,R,Novela%20z.%20v%20souv.%20s%20p%u0159ijet%EDm%20rekodifikace%20soukrom%E9ho%20pr%E1va%20-%20EU
58192,11,1375912800,68,16,33,13,130,A,Novela%20z.%20v%20souv.%20s%20p%u0159ijet%EDm%20rekodifikace%20soukrom%E9ho%20pr%E1va%20-%20EU
58193,11,1375912800,69,15,33,13,130,A,Novela%20z.%20v%20souv.%20s%20p%u0159ijet%EDm%20rekodifikace%20soukrom%E9ho%20pr%E1va%20-%20EU
58194,11,1375912800,67,43,10,8,128,A,Novela%20z.%20v%20souv.%20s%20p%u0159ijet%EDm%20rekodifikace%20soukrom%E9ho%20pr%E1va%20-%20EU
58195,12,1375912800,66,18,32,13,129,A,Vl.n.z.%20o%20zvl%E1%u0161tn%EDch%20%u0159%EDzen%EDch%20soudn%EDch%20-%20EU
58196,12,1375912800,65,15,37,12,129,A,Vl.n.z.%20o%20zvl%E1%u0161tn%EDch%20%u0159%EDzen%EDch%20soudn%EDch%20-%20EU
58197,12,1375912800,42,58,17,12,129,R,Vl.n.z.%20o%20zvl%E1%u0161tn%EDch%20%u0159%EDzen%EDch%20soudn%EDch%20-%20EU
58198,12,1375912800,66,10,38,15,129,A,Vl.n.z.%20o%20zvl%E1%u0161tn%EDch%20%u0159%EDzen%EDch%20soudn%EDch%20-%20EU
58199,12,1375912800,65,20,33,11,129,A,Vl.n.z.%20o%20zvl%E1%u0161tn%EDch%20%u0159%EDzen%EDch%20soudn%EDch%20-%20EU
58200,13,1375912800,58,15,43,12,128,R,Novela%20z.%20-%20ob%u010Dansk%FD%20soudn%ED%20%u0159%E1d
58201,13,1375912800,85,14,13,2,114,A,Novela%20z.%20-%20ob%u010Dansk%FD%20soudn%ED%20%u0159%E1d
58202,13,1375912800,63,16,22,13,114,A,Novela%20z.%20-%20ob%u010Dansk%FD%20soudn%ED%20%u0159%E1d
58203,13,1375912800,68,9,25,13,115,A,Novela%20z.%20-%20ob%u010Dansk%FD%20soudn%ED%20%u0159%E1d
58204,13,1375912800,68,21,19,11,119,A,Novela%20z.%20-%20ob%u010Dansk%FD%20soudn%ED%20%u0159%E1d
58205,14,1375912800,86,5,26,6,123,A,Vl.n.z.%20o%20st%E1tn%EDm%20dluhopisov%E9m%20programu
58206,15,1375912800,98,2,15,8,123,A,Novela%20z.%20o%20st%E1tn%EDm%20rozpo%u010Dtu%20%u010CR%20na%20rok%202013
58207,16,1375912800,98,1,18,1,118,A,Vl.n.z.%20o%20povinn%E9m%20zna%u010Den%ED%20lihu%20-%20EU
58208,16,1375912800,27,76,12,4,119,R,Vl.n.z.%20o%20povinn%E9m%20zna%u010Den%ED%20lihu%20-%20EU
58209,16,1375912800,33,56,28,2,119,R,Vl.n.z.%20o%20povinn%E9m%20zna%u010Den%ED%20lihu%20-%20EU
58210,16,1375912800,104,2,13,0,119,A,Vl.n.z.%20o%20povinn%E9m%20zna%u010Den%ED%20lihu%20-%20EU
58211,16,1375912800,86,16,14,3,119,A,Vl.n.z.%20o%20povinn%E9m%20zna%u010Den%ED%20lihu%20-%20EU
58212,16,1375912800,100,2,15,2,119,A,Vl.n.z.%20o%20povinn%E9m%20zna%u010Den%ED%20lihu%20-%20EU
58213,16,1375912800,29,55,31,4,119,R,Vl.n.z.%20o%20povinn%E9m%20zna%u010Den%ED%20lihu%20-%20EU
58214,16,1375912800,51,45,17,6,119,R,Vl.n.z.%20o%20povinn%E9m%20zna%u010Den%ED%20lihu%20-%20EU
58215,16,1375912800,106,0,10,3,119,A,Vl.n.z.%20o%20povinn%E9m%20zna%u010Den%ED%20lihu%20-%20EU
58216,17,1375912800,10,69,20,19,118,R,Vl.n.z.%20o%20povinn%E9m%20zna%u010Den%ED%20lihu%20-%20souvisej%EDc%ED
58217,17,1375912800,28,74,18,0,120,R,Vl.n.z.%20o%20povinn%E9m%20zna%u010Den%ED%20lihu%20-%20souvisej%EDc%ED
58218,17,1375912800,78,27,15,0,120,A,Vl.n.z.%20o%20povinn%E9m%20zna%u010Den%ED%20lihu%20-%20souvisej%EDc%ED
58219,17,1375912800,107,0,11,2,120,A,Vl.n.z.%20o%20povinn%E9m%20zna%u010Den%ED%20lihu%20-%20souvisej%EDc%ED
58220,18,1375912800,92,0,23,1,116,A,Novela%20z.%20-%20%u017Eivnostensk%FD%20z%E1kon
58221,18,1375912800,96,0,19,0,115,A,Novela%20z.%20-%20%u017Eivnostensk%FD%20z%E1kon
58222,19,1375912800,60,13,30,13,116,A,Vl.n.z.o%20ve%u0159ejn%FDch%20rejst%u0159%EDc%EDch%20pr%E1vnick%FDch%20a%20fyzick%FDch%20osob%20-%20EU
58223,19,1375912800,46,48,19,3,116,R,Vl.n.z.o%20ve%u0159ejn%FDch%20rejst%u0159%EDc%EDch%20pr%E1vnick%FDch%20a%20fyzick%FDch%20osob%20-%20EU
58224,19,1375912800,88,10,14,4,116,A,Vl.n.z.o%20ve%u0159ejn%FDch%20rejst%u0159%EDc%EDch%20pr%E1vnick%FDch%20a%20fyzick%FDch%20osob%20-%20EU
58225,19,1375912800,55,20,34,7,116,R,Vl.n.z.o%20ve%u0159ejn%FDch%20rejst%u0159%EDc%EDch%20pr%E1vnick%FDch%20a%20fyzick%FDch%20osob%20-%20EU
58226,19,1375912800,87,0,17,2,106,A,Vl.n.z.o%20ve%u0159ejn%FDch%20rejst%u0159%EDc%EDch%20pr%E1vnick%FDch%20a%20fyzick%FDch%20osob%20-%20EU
58227,19,1375912800,60,25,22,3,110,A,Vl.n.z.o%20ve%u0159ejn%FDch%20rejst%u0159%EDc%EDch%20pr%E1vnick%FDch%20a%20fyzick%FDch%20osob%20-%20EU
58228,20,1375912800,83,0,29,3,115,A,Vl.n.z.%20o%20statusu%20ve%u0159ejn%E9%20prosp%u011B%u0161nosti
58229,20,1375912800,64,8,33,10,115,A,Vl.n.z.%20o%20statusu%20ve%u0159ejn%E9%20prosp%u011B%u0161nosti
58230,20,1375912800,6,80,29,1,116,R,Vl.n.z.%20o%20statusu%20ve%u0159ejn%E9%20prosp%u011B%u0161nosti
58231,20,1375912800,24,60,29,3,116,R,Vl.n.z.%20o%20statusu%20ve%u0159ejn%E9%20prosp%u011B%u0161nosti
58232,20,1375912800,24,59,29,4,116,R,Vl.n.z.%20o%20statusu%20ve%u0159ejn%E9%20prosp%u011B%u0161nosti
58233,20,1375912800,6,78,29,3,116,R,Vl.n.z.%20o%20statusu%20ve%u0159ejn%E9%20prosp%u011B%u0161nosti
58234,20,1375912800,23,60,30,3,116,R,Vl.n.z.%20o%20statusu%20ve%u0159ejn%E9%20prosp%u011B%u0161nosti
58235,20,1375912800,34,29,41,12,116,R,Vl.n.z.%20o%20statusu%20ve%u0159ejn%E9%20prosp%u011B%u0161nosti
58236,20,1375912800,8,74,31,3,116,R,Vl.n.z.%20o%20statusu%20ve%u0159ejn%E9%20prosp%u011B%u0161nosti
58237,20,1375912800,47,60,8,0,115,R,Vl.n.z.%20o%20statusu%20ve%u0159ejn%E9%20prosp%u011B%u0161nosti
58238,20,1375912800,67,7,33,10,117,A,Vl.n.z.%20o%20statusu%20ve%u0159ejn%E9%20prosp%u011B%u0161nosti
58239,20,1375912800,62,43,11,2,118,A,Vl.n.z.%20o%20statusu%20ve%u0159ejn%E9%20prosp%u011B%u0161nosti
58240,21,1375912800,111,0,9,0,120,A,Vl.n.z.%20o%20p%u0159evodu%20vlastnick%E9ho%20pr%E1va
58241,21,1375912800,112,0,8,0,120,A,Vl.n.z.%20o%20p%u0159evodu%20vlastnick%E9ho%20pr%E1va
58242,22,1375912800,100,0,18,0,118,A,Novela%20z.%20o%20matrik%E1ch%2C%20jm%E9nu%20a%20p%u0159%EDjmen%ED
58243,22,1375912800,102,0,4,0,106,A,Novela%20z.%20o%20matrik%E1ch%2C%20jm%E9nu%20a%20p%u0159%EDjmen%ED
58244,22,1375912800,85,3,21,3,112,A,Novela%20z.%20o%20matrik%E1ch%2C%20jm%E9nu%20a%20p%u0159%EDjmen%ED
58245,6,1375912800,104,0,10,0,114,A,Novela%20z.%20o%20podporovan%FDch%20zdroj%EDch%20energie%20-%20EU
58246,6,1375912800,77,22,13,3,115,A,Novela%20z.%20o%20podporovan%FDch%20zdroj%EDch%20energie%20-%20EU
58247,6,1375912800,104,0,12,0,116,A,Novela%20z.%20o%20podporovan%FDch%20zdroj%EDch%20energie%20-%20EU
58248,0,1375912800,97,1,17,2,117,A,%20
58249,0,1375912800,77,1,36,3,117,A,%20
58250,5,1375912800,87,0,27,0,114,A,Novela%20z.%20o%20soci%E1ln%EDch%20slu%u017Eb%E1ch
58251,5,1375912800,61,6,38,9,114,A,Novela%20z.%20o%20soci%E1ln%EDch%20slu%u017Eb%E1ch
